STATE,CNTYCD,COUNTYNAME,COUNTY,STATEDESC,YEAR,FORCE,EMPLOYED,UNEMPLOYED,UNEMPLOYMENTRATE
1,1,"Autauga County, AL",Autauga County, AL,2011,25836,23677,2159,8.4
1,3,"Baldwin County, AL",Baldwin County, AL,2011,85045,77418,7627,9
1,5,"Barbour County, AL",Barbour County, AL,2011,9849,8712,1137,11.5
1,7,"Bibb County, AL",Bibb County, AL,2011,8933,7996,937,10.5
1,9,"Blount County, AL",Blount County, AL,2011,25123,22939,2184,8.7
1,11,"Bullock County, AL",Bullock County, AL,2011,4833,4272,561,11.6
1,13,"Butler County, AL",Butler County, AL,2011,9188,8042,1146,12.5
1,15,"Calhoun County, AL",Calhoun County, AL,2011,51268,45963,5305,10.3
1,17,"Chambers County, AL",Chambers County, AL,2011,15200,13380,1820,12
1,19,"Cherokee County, AL",Cherokee County, AL,2011,11476,10364,1112,9.7
1,21,"Chilton County, AL",Chilton County, AL,2011,19539,17753,1786,9.1
1,23,"Choctaw County, AL",Choctaw County, AL,2011,4764,4138,626,13.1
1,25,"Clarke County, AL",Clarke County, AL,2011,8843,7181,1662,18.8
1,27,"Clay County, AL",Clay County, AL,2011,5598,4935,663,11.8
1,29,"Cleburne County, AL",Cleburne County, AL,2011,5939,5365,574,9.7
1,31,"Coffee County, AL",Coffee County, AL,2011,20749,19059,1690,8.1
1,33,"Colbert County, AL",Colbert County, AL,2011,24386,21905,2481,10.2
1,35,"Conecuh County, AL",Conecuh County, AL,2011,4785,4057,728,15.2
1,37,"Coosa County, AL",Coosa County, AL,2011,4477,3918,559,12.5
1,39,"Covington County, AL",Covington County, AL,2011,16367,14764,1603,9.8
1,41,"Crenshaw County, AL",Crenshaw County, AL,2011,6432,5798,634,9.9
1,43,"Cullman County, AL",Cullman County, AL,2011,35669,32279,3390,9.5
1,45,"Dale County, AL",Dale County, AL,2011,22017,20188,1829,8.3
1,47,"Dallas County, AL",Dallas County, AL,2011,17514,14866,2648,15.1
1,49,"DeKalb County, AL",DeKalb County, AL,2011,29809,26279,3530,11.8
1,51,"Elmore County, AL",Elmore County, AL,2011,36597,33521,3076,8.4
1,53,"Escambia County, AL",Escambia County, AL,2011,14978,13355,1623,10.8
1,55,"Etowah County, AL",Etowah County, AL,2011,44722,40238,4484,10
1,57,"Fayette County, AL",Fayette County, AL,2011,6632,5896,736,11.1
1,59,"Franklin County, AL",Franklin County, AL,2011,14362,12986,1376,9.6
1,61,"Geneva County, AL",Geneva County, AL,2011,11486,10429,1057,9.2
1,63,"Greene County, AL",Greene County, AL,2011,3226,2668,558,17.3
1,65,"Hale County, AL",Hale County, AL,2011,6296,5426,870,13.8
1,67,"Henry County, AL",Henry County, AL,2011,7270,6563,707,9.7
1,69,"Houston County, AL",Houston County, AL,2011,46778,42747,4031,8.6
1,71,"Jackson County, AL",Jackson County, AL,2011,24163,21682,2481,10.3
1,73,"Jefferson County, AL",Jefferson County, AL,2011,319652,289916,29736,9.3
1,75,"Lamar County, AL",Lamar County, AL,2011,5826,5260,566,9.7
1,77,"Lauderdale County, AL",Lauderdale County, AL,2011,44048,40026,4022,9.1
1,79,"Lawrence County, AL",Lawrence County, AL,2011,14788,13177,1611,10.9
1,81,"Lee County, AL",Lee County, AL,2011,68316,62812,5504,8.1
1,83,"Limestone County, AL",Limestone County, AL,2011,38990,35631,3359,8.6
1,85,"Lowndes County, AL",Lowndes County, AL,2011,4239,3489,750,17.7
1,87,"Macon County, AL",Macon County, AL,2011,8512,7317,1195,14
1,89,"Madison County, AL",Madison County, AL,2011,171726,157512,14214,8.3
1,91,"Marengo County, AL",Marengo County, AL,2011,7875,6884,991,12.6
1,93,"Marion County, AL",Marion County, AL,2011,12556,11149,1407,11.2
1,95,"Marshall County, AL",Marshall County, AL,2011,41085,37216,3869,9.4
1,97,"Mobile County, AL",Mobile County, AL,2011,193851,172971,20880,10.8
1,99,"Monroe County, AL",Monroe County, AL,2011,8325,7017,1308,15.7
1,101,"Montgomery County, AL",Montgomery County, AL,2011,109092,98491,10601,9.7
1,103,"Morgan County, AL",Morgan County, AL,2011,58319,52810,5509,9.4
1,105,"Perry County, AL",Perry County, AL,2011,3866,3227,639,16.5
1,107,"Pickens County, AL",Pickens County, AL,2011,7570,6663,907,12
1,109,"Pike County, AL",Pike County, AL,2011,15438,14070,1368,8.9
1,111,"Randolph County, AL",Randolph County, AL,2011,9447,8374,1073,11.4
1,113,"Russell County, AL",Russell County, AL,2011,24604,22077,2527,10.3
1,115,"St. Clair County, AL",St. Clair County, AL,2011,38509,35135,3374,8.8
1,117,"Shelby County, AL",Shelby County, AL,2011,104214,97727,6487,6.2
1,119,"Sumter County, AL",Sumter County, AL,2011,5560,4829,731,13.1
1,121,"Talladega County, AL",Talladega County, AL,2011,35293,31192,4101,11.6
1,123,"Tallapoosa County, AL",Tallapoosa County, AL,2011,18363,16266,2097,11.4
1,125,"Tuscaloosa County, AL",Tuscaloosa County, AL,2011,95463,87532,7931,8.3
1,127,"Walker County, AL",Walker County, AL,2011,27092,24034,3058,11.3
1,129,"Washington County, AL",Washington County, AL,2011,7106,6070,1036,14.6
1,131,"Wilcox County, AL",Wilcox County, AL,2011,2979,2289,690,23.2
1,133,"Winston County, AL",Winston County, AL,2011,9819,8492,1327,13.5
2,13,"Aleutians East Borough, AK",Aleutians East Borough, AK,2011,2183,2048,135,6.2
2,16,"Aleutians West Census Area, AK",Aleutians West Census Area, AK,2011,4255,4007,248,5.8
2,20,"Anchorage Borough/municipality, AK",Anchorage Borough/municipality, AK,2011,159006,149542,9464,6
2,50,"Bethel Census Area, AK",Bethel Census Area, AK,2011,7221,6137,1084,15
2,60,"Bristol Bay Borough, AK",Bristol Bay Borough, AK,2011,518,472,46,8.9
2,68,"Denali Borough, AK",Denali Borough, AK,2011,1018,879,139,13.7
2,70,"Dillingham Census Area, AK",Dillingham Census Area, AK,2011,2106,1883,223,10.6
2,90,"Fairbanks North Star Borough, AK",Fairbanks North Star Borough, AK,2011,48354,45238,3116,6.4
2,100,"Haines Borough, AK",Haines Borough, AK,2011,1167,1050,117,10
2,105,"Hoonah-Angoon Census Area, AK",Hoonah-Angoon Census Area, AK,2011,1099,933,166,15.1
2,110,"Juneau Borough/city, AK",Juneau Borough/city, AK,2011,17907,16913,994,5.6
2,122,"Kenai Peninsula Borough, AK",Kenai Peninsula Borough, AK,2011,27273,24675,2598,9.5
2,130,"Ketchikan Gateway Borough, AK",Ketchikan Gateway Borough, AK,2011,7180,6560,620,8.6
2,150,"Kodiak Island Borough, AK",Kodiak Island Borough, AK,2011,6783,6281,502,7.4
2,158,"Kusilvak Census Area, AK",Kusilvak Census Area, AK,2011,2759,2177,582,21.1
2,164,"Lake and Peninsula Borough, AK",Lake and Peninsula Borough, AK,2011,638,542,96,15
2,170,"Matanuska-Susitna Borough, AK",Matanuska-Susitna Borough, AK,2011,43368,39390,3978,9.2
2,180,"Nome Census Area, AK",Nome Census Area, AK,2011,4127,3619,508,12.3
2,185,"North Slope Borough, AK",North Slope Borough, AK,2011,3993,3690,303,7.6
2,188,"Northwest Arctic Borough, AK",Northwest Arctic Borough, AK,2011,2987,2524,463,15.5
2,195,"Petersburg Borough, AK",Petersburg Borough, AK,2011,1856,1701,155,8.4
2,198,"Prince of Wales-Hyder Census Area, AK",Prince of Wales-Hyder Census Area, AK,2011,2572,2254,318,12.4
2,220,"Sitka Borough/city, AK",Sitka Borough/city, AK,2011,4632,4348,284,6.1
2,230,"Skagway Municipality, AK",Skagway Municipality, AK,2011,716,600,116,16.2
2,240,"Southeast Fairbanks Census Area, AK",Southeast Fairbanks Census Area, AK,2011,3202,2804,398,12.4
2,261,"Valdez-Cordova Census Area, AK",Valdez-Cordova Census Area, AK,2011,4938,4449,489,9.9
2,275,"Wrangell Borough/city, AK",Wrangell Borough/city, AK,2011,1051,972,79,7.5
2,282,"Yakutat Borough/city, AK",Yakutat Borough/city, AK,2011,301,269,32,10.6
2,290,"Yukon-Koyukuk Census Area, AK",Yukon-Koyukuk Census Area, AK,2011,2706,2208,498,18.4
4,1,"Apache County, AZ",Apache County, AZ,2011,23040,18788,4252,18.5
4,3,"Cochise County, AZ",Cochise County, AZ,2011,55917,50589,5328,9.5
4,5,"Coconino County, AZ",Coconino County, AZ,2011,71682,64846,6836,9.5
4,7,"Gila County, AZ",Gila County, AZ,2011,21171,18725,2446,11.6
4,9,"Graham County, AZ",Graham County, AZ,2011,14345,12916,1429,10
4,11,"Greenlee County, AZ",Greenlee County, AZ,2011,3352,2982,370,11
4,12,"La Paz County, AZ",La Paz County, AZ,2011,7827,7057,770,9.8
4,13,"Maricopa County, AZ",Maricopa County, AZ,2011,1894633,1732510,162123,8.6
4,15,"Mohave County, AZ",Mohave County, AZ,2011,79594,69823,9771,12.3
4,17,"Navajo County, AZ",Navajo County, AZ,2011,43344,36914,6430,14.8
4,19,"Pima County, AZ",Pima County, AZ,2011,466908,427335,39573,8.5
4,21,"Pinal County, AZ",Pinal County, AZ,2011,149658,135043,14615,9.8
4,23,"Santa Cruz County, AZ",Santa Cruz County, AZ,2011,20478,17311,3167,15.5
4,25,"Yavapai County, AZ",Yavapai County, AZ,2011,93132,83953,9179,9.9
4,27,"Yuma County, AZ",Yuma County, AZ,2011,91935,69677,22258,24.2
5,1,"Arkansas County, AR",Arkansas County, AR,2011,10589,9297,1292,12.2
5,3,"Ashley County, AR",Ashley County, AR,2011,9886,8780,1106,11.2
5,5,"Baxter County, AR",Baxter County, AR,2011,16602,15061,1541,9.3
5,7,"Benton County, AR",Benton County, AR,2011,109574,102441,7133,6.5
5,9,"Boone County, AR",Boone County, AR,2011,16697,15367,1330,8
5,11,"Bradley County, AR",Bradley County, AR,2011,4560,3988,572,12.5
5,13,"Calhoun County, AR",Calhoun County, AR,2011,2639,2385,254,9.6
5,15,"Carroll County, AR",Carroll County, AR,2011,12896,11964,932,7.2
5,17,"Chicot County, AR",Chicot County, AR,2011,4282,3718,564,13.2
5,19,"Clark County, AR",Clark County, AR,2011,10335,9261,1074,10.4
5,21,"Clay County, AR",Clay County, AR,2011,7304,6419,885,12.1
5,23,"Cleburne County, AR",Cleburne County, AR,2011,10551,9579,972,9.2
5,25,"Cleveland County, AR",Cleveland County, AR,2011,3885,3554,331,8.5
5,27,"Columbia County, AR",Columbia County, AR,2011,10445,9401,1044,10
5,29,"Conway County, AR",Conway County, AR,2011,9038,8145,893,9.9
5,31,"Craighead County, AR",Craighead County, AR,2011,49190,45556,3634,7.4
5,33,"Crawford County, AR",Crawford County, AR,2011,28020,25539,2481,8.9
5,35,"Crittenden County, AR",Crittenden County, AR,2011,22778,20293,2485,10.9
5,37,"Cross County, AR",Cross County, AR,2011,8832,8092,740,8.4
5,39,"Dallas County, AR",Dallas County, AR,2011,3322,2908,414,12.5
5,41,"Desha County, AR",Desha County, AR,2011,6151,5464,687,11.2
5,43,"Drew County, AR",Drew County, AR,2011,8656,7651,1005,11.6
5,45,"Faulkner County, AR",Faulkner County, AR,2011,59482,55206,4276,7.2
5,47,"Franklin County, AR",Franklin County, AR,2011,7799,7201,598,7.7
5,49,"Fulton County, AR",Fulton County, AR,2011,5127,4729,398,7.8
5,51,"Garland County, AR",Garland County, AR,2011,41787,38127,3660,8.8
5,53,"Grant County, AR",Grant County, AR,2011,8560,7928,632,7.4
5,55,"Greene County, AR",Greene County, AR,2011,20147,18189,1958,9.7
5,57,"Hempstead County, AR",Hempstead County, AR,2011,11024,10049,975,8.8
5,59,"Hot Spring County, AR",Hot Spring County, AR,2011,14527,13320,1207,8.3
5,61,"Howard County, AR",Howard County, AR,2011,6746,6240,506,7.5
5,63,"Independence County, AR",Independence County, AR,2011,16711,15149,1562,9.3
5,65,"Izard County, AR",Izard County, AR,2011,5232,4713,519,9.9
5,67,"Jackson County, AR",Jackson County, AR,2011,6714,5935,779,11.6
5,69,"Jefferson County, AR",Jefferson County, AR,2011,33727,29978,3749,11.1
5,71,"Johnson County, AR",Johnson County, AR,2011,11134,10256,878,7.9
5,73,"Lafayette County, AR",Lafayette County, AR,2011,3007,2716,291,9.7
5,75,"Lawrence County, AR",Lawrence County, AR,2011,7471,6731,740,9.9
5,77,"Lee County, AR",Lee County, AR,2011,3678,3326,352,9.6
5,79,"Lincoln County, AR",Lincoln County, AR,2011,4782,4335,447,9.3
5,81,"Little River County, AR",Little River County, AR,2011,6143,5662,481,7.8
5,83,"Logan County, AR",Logan County, AR,2011,9641,8790,851,8.8
5,85,"Lonoke County, AR",Lonoke County, AR,2011,33448,31123,2325,7
5,87,"Madison County, AR",Madison County, AR,2011,7244,6753,491,6.8
5,89,"Marion County, AR",Marion County, AR,2011,6758,6120,638,9.4
5,91,"Miller County, AR",Miller County, AR,2011,20808,19484,1324,6.4
5,93,"Mississippi County, AR",Mississippi County, AR,2011,20984,18454,2530,12.1
5,95,"Monroe County, AR",Monroe County, AR,2011,3390,3067,323,9.5
5,97,"Montgomery County, AR",Montgomery County, AR,2011,3826,3470,356,9.3
5,99,"Nevada County, AR",Nevada County, AR,2011,4180,3784,396,9.5
5,101,"Newton County, AR",Newton County, AR,2011,3803,3518,285,7.5
5,103,"Ouachita County, AR",Ouachita County, AR,2011,11066,9900,1166,10.5
5,105,"Perry County, AR",Perry County, AR,2011,4520,4098,422,9.3
5,107,"Phillips County, AR",Phillips County, AR,2011,8447,7421,1026,12.1
5,109,"Pike County, AR",Pike County, AR,2011,4654,4186,468,10.1
5,111,"Poinsett County, AR",Poinsett County, AR,2011,10817,9783,1034,9.6
5,113,"Polk County, AR",Polk County, AR,2011,8947,8226,721,8.1
5,115,"Pope County, AR",Pope County, AR,2011,30517,28125,2392,7.8
5,117,"Prairie County, AR",Prairie County, AR,2011,3937,3596,341,8.7
5,119,"Pulaski County, AR",Pulaski County, AR,2011,190083,175884,14199,7.5
5,121,"Randolph County, AR",Randolph County, AR,2011,7186,6375,811,11.3
5,123,"St. Francis County, AR",St. Francis County, AR,2011,9824,8729,1095,11.1
5,125,"Saline County, AR",Saline County, AR,2011,54212,50604,3608,6.7
5,127,"Scott County, AR",Scott County, AR,2011,4832,4489,343,7.1
5,129,"Searcy County, AR",Searcy County, AR,2011,3336,3030,306,9.2
5,131,"Sebastian County, AR",Sebastian County, AR,2011,59600,54442,5158,8.7
5,133,"Sevier County, AR",Sevier County, AR,2011,6402,5812,590,9.2
5,135,"Sharp County, AR",Sharp County, AR,2011,6294,5619,675,10.7
5,137,"Stone County, AR",Stone County, AR,2011,5402,4919,483,8.9
5,139,"Union County, AR",Union County, AR,2011,16977,15187,1790,10.5
5,141,"Van Buren County, AR",Van Buren County, AR,2011,6756,6010,746,11
5,143,"Washington County, AR",Washington County, AR,2011,104823,98216,6607,6.3
5,145,"White County, AR",White County, AR,2011,36768,33580,3188,8.7
5,147,"Woodruff County, AR",Woodruff County, AR,2011,3571,3179,392,11
5,149,"Yell County, AR",Yell County, AR,2011,9605,8886,719,7.5
6,1,"Alameda County, CA",Alameda County, CA,2011,786756,707381,79375,10.1
6,3,"Alpine County, CA",Alpine County, CA,2011,593,517,76,12.8
6,5,"Amador County, CA",Amador County, CA,2011,15095,13040,2055,13.6
6,7,"Butte County, CA",Butte County, CA,2011,100647,86891,13756,13.7
6,9,"Calaveras County, CA",Calaveras County, CA,2011,20668,17769,2899,14
6,11,"Colusa County, CA",Colusa County, CA,2011,11376,8959,2417,21.2
6,13,"Contra Costa County, CA",Contra Costa County, CA,2011,529551,475011,54540,10.3
6,15,"Del Norte County, CA",Del Norte County, CA,2011,10895,9446,1449,13.3
6,17,"El Dorado County, CA",El Dorado County, CA,2011,89690,79188,10502,11.7
6,19,"Fresno County, CA",Fresno County, CA,2011,443509,370224,73285,16.5
6,21,"Glenn County, CA",Glenn County, CA,2011,13167,11124,2043,15.5
6,23,"Humboldt County, CA",Humboldt County, CA,2011,65106,58228,6878,10.6
6,25,"Imperial County, CA",Imperial County, CA,2011,79456,56524,22932,28.9
6,27,"Inyo County, CA",Inyo County, CA,2011,9682,8741,941,9.7
6,29,"Kern County, CA",Kern County, CA,2011,382367,325712,56655,14.8
6,31,"Kings County, CA",Kings County, CA,2011,59123,49718,9405,15.9
6,33,"Lake County, CA",Lake County, CA,2011,29611,25310,4301,14.5
6,35,"Lassen County, CA",Lassen County, CA,2011,11785,10190,1595,13.5
6,37,"Los Angeles County, CA",Los Angeles County, CA,2011,4928464,4327923,600541,12.2
6,39,"Madera County, CA",Madera County, CA,2011,62014,51990,10024,16.2
6,41,"Marin County, CA",Marin County, CA,2011,134576,124801,9775,7.3
6,43,"Mariposa County, CA",Mariposa County, CA,2011,8661,7520,1141,13.2
6,45,"Mendocino County, CA",Mendocino County, CA,2011,40953,36284,4669,11.4
6,47,"Merced County, CA",Merced County, CA,2011,114735,94500,20235,17.6
6,49,"Modoc County, CA",Modoc County, CA,2011,3620,3042,578,16
6,51,"Mono County, CA",Mono County, CA,2011,8832,7944,888,10.1
6,53,"Monterey County, CA",Monterey County, CA,2011,216558,189146,27412,12.7
6,55,"Napa County, CA",Napa County, CA,2011,70760,63846,6914,9.8
6,57,"Nevada County, CA",Nevada County, CA,2011,49021,43590,5431,11.1
6,59,"Orange County, CA",Orange County, CA,2011,1546389,1406411,139978,9.1
6,61,"Placer County, CA",Placer County, CA,2011,173744,154923,18821,10.8
6,63,"Plumas County, CA",Plumas County, CA,2011,8890,7326,1564,17.6
6,65,"Riverside County, CA",Riverside County, CA,2011,978514,849635,128879,13.2
6,67,"Sacramento County, CA",Sacramento County, CA,2011,679995,597683,82312,12.1
6,69,"San Benito County, CA",San Benito County, CA,2011,28281,24179,4102,14.5
6,71,"San Bernardino County, CA",San Bernardino County, CA,2011,888513,774166,114347,12.9
6,73,"San Diego County, CA",San Diego County, CA,2011,1524582,1367250,157332,10.3
6,75,"San Francisco County/city, CA",San Francisco County/city, CA,2011,494760,454861,39899,8.1
6,77,"San Joaquin County, CA",San Joaquin County, CA,2011,311363,260997,50366,16.2
6,79,"San Luis Obispo County, CA",San Luis Obispo County, CA,2011,134374,121509,12865,9.6
6,81,"San Mateo County, CA",San Mateo County, CA,2011,399859,369827,30032,7.5
6,83,"Santa Barbara County, CA",Santa Barbara County, CA,2011,213005,193023,19982,9.4
6,85,"Santa Clara County, CA",Santa Clara County, CA,2011,939851,852426,87425,9.3
6,87,"Santa Cruz County, CA",Santa Cruz County, CA,2011,141335,122865,18470,13.1
6,89,"Shasta County, CA",Shasta County, CA,2011,77044,64762,12282,15.9
6,91,"Sierra County, CA",Sierra County, CA,2011,1601,1363,238,14.9
6,93,"Siskiyou County, CA",Siskiyou County, CA,2011,19435,16134,3301,17
6,95,"Solano County, CA",Solano County, CA,2011,202241,177619,24622,12.2
6,97,"Sonoma County, CA",Sonoma County, CA,2011,246171,220958,25213,10.2
6,99,"Stanislaus County, CA",Stanislaus County, CA,2011,242320,202360,39960,16.5
6,101,"Sutter County, CA",Sutter County, CA,2011,45939,37596,8343,18.2
6,103,"Tehama County, CA",Tehama County, CA,2011,25574,21744,3830,15
6,105,"Trinity County, CA",Trinity County, CA,2011,5385,4486,899,16.7
6,107,"Tulare County, CA",Tulare County, CA,2011,203474,168687,34787,17.1
6,109,"Tuolumne County, CA",Tuolumne County, CA,2011,22725,19440,3285,14.5
6,111,"Ventura County, CA",Ventura County, CA,2011,431718,387495,44223,10.2
6,113,"Yolo County, CA",Yolo County, CA,2011,101806,89818,11988,11.8
6,115,"Yuba County, CA",Yuba County, CA,2011,28948,24035,4913,17
8,1,"Adams County, CO",Adams County, CO,2011,236385,212931,23454,9.9
8,3,"Alamosa County, CO",Alamosa County, CO,2011,7684,6942,742,9.7
8,5,"Arapahoe County, CO",Arapahoe County, CO,2011,319253,292867,26386,8.3
8,7,"Archuleta County, CO",Archuleta County, CO,2011,5748,5169,579,10.1
8,9,"Baca County, CO",Baca County, CO,2011,2068,1969,99,4.8
8,11,"Bent County, CO",Bent County, CO,2011,1929,1770,159,8.2
8,13,"Boulder County, CO",Boulder County, CO,2011,172002,160904,11098,6.5
8,14,"Broomfield County/city, CO",Broomfield County/city, CO,2011,31768,29539,2229,7
8,15,"Chaffee County, CO",Chaffee County, CO,2011,8301,7702,599,7.2
8,17,"Cheyenne County, CO",Cheyenne County, CO,2011,1050,1006,44,4.2
8,19,"Clear Creek County, CO",Clear Creek County, CO,2011,5500,5094,406,7.4
8,21,"Conejos County, CO",Conejos County, CO,2011,3728,3338,390,10.5
8,23,"Costilla County, CO",Costilla County, CO,2011,1582,1397,185,11.7
8,25,"Crowley County, CO",Crowley County, CO,2011,1488,1356,132,8.9
8,27,"Custer County, CO",Custer County, CO,2011,2017,1889,128,6.3
8,29,"Delta County, CO",Delta County, CO,2011,14409,12905,1504,10.4
8,31,"Denver County/city, CO",Denver County/city, CO,2011,352226,321953,30273,8.6
8,33,"Dolores County, CO",Dolores County, CO,2011,947,826,121,12.8
8,35,"Douglas County, CO",Douglas County, CO,2011,158279,148154,10125,6.4
8,37,"Eagle County, CO",Eagle County, CO,2011,32147,29624,2523,7.8
8,39,"Elbert County, CO",Elbert County, CO,2011,12674,11724,950,7.5
8,41,"El Paso County, CO",El Paso County, CO,2011,307563,279542,28021,9.1
8,43,"Fremont County, CO",Fremont County, CO,2011,15916,14005,1911,12
8,45,"Garfield County, CO",Garfield County, CO,2011,31376,28404,2972,9.5
8,47,"Gilpin County, CO",Gilpin County, CO,2011,3269,3033,236,7.2
8,49,"Grand County, CO",Grand County, CO,2011,8795,8087,708,8.1
8,51,"Gunnison County, CO",Gunnison County, CO,2011,9935,9336,599,6
8,53,"Hinsdale County, CO",Hinsdale County, CO,2011,473,449,24,5.1
8,55,"Huerfano County, CO",Huerfano County, CO,2011,2659,2298,361,13.6
8,57,"Jackson County, CO",Jackson County, CO,2011,893,839,54,6
8,59,"Jefferson County, CO",Jefferson County, CO,2011,302402,278353,24049,8
8,61,"Kiowa County, CO",Kiowa County, CO,2011,836,794,42,5
8,63,"Kit Carson County, CO",Kit Carson County, CO,2011,4265,4065,200,4.7
8,65,"Lake County, CO",Lake County, CO,2011,4377,3936,441,10.1
8,67,"La Plata County, CO",La Plata County, CO,2011,29476,27408,2068,7
8,69,"Larimer County, CO",Larimer County, CO,2011,170942,158704,12238,7.2
8,71,"Las Animas County, CO",Las Animas County, CO,2011,6977,6208,769,11
8,73,"Lincoln County, CO",Lincoln County, CO,2011,2193,2054,139,6.3
8,75,"Logan County, CO",Logan County, CO,2011,11081,10388,693,6.3
8,77,"Mesa County, CO",Mesa County, CO,2011,75475,67738,7737,10.3
8,79,"Mineral County, CO",Mineral County, CO,2011,426,403,23,5.4
8,81,"Moffat County, CO",Moffat County, CO,2011,7861,7130,731,9.3
8,83,"Montezuma County, CO",Montezuma County, CO,2011,12986,11850,1136,8.7
8,85,"Montrose County, CO",Montrose County, CO,2011,20017,17805,2212,11.1
8,87,"Morgan County, CO",Morgan County, CO,2011,15043,14040,1003,6.7
8,89,"Otero County, CO",Otero County, CO,2011,8473,7629,844,10
8,91,"Ouray County, CO",Ouray County, CO,2011,2023,1817,206,10.2
8,93,"Park County, CO",Park County, CO,2011,9406,8683,723,7.7
8,95,"Phillips County, CO",Phillips County, CO,2011,2154,2039,115,5.3
8,97,"Pitkin County, CO",Pitkin County, CO,2011,10926,10072,854,7.8
8,99,"Prowers County, CO",Prowers County, CO,2011,6242,5829,413,6.6
8,101,"Pueblo County, CO",Pueblo County, CO,2011,75117,67211,7906,10.5
8,103,"Rio Blanco County, CO",Rio Blanco County, CO,2011,3119,2874,245,7.9
8,105,"Rio Grande County, CO",Rio Grande County, CO,2011,5152,4519,633,12.3
8,107,"Routt County, CO",Routt County, CO,2011,14288,13111,1177,8.2
8,109,"Saguache County, CO",Saguache County, CO,2011,3015,2679,336,11.1
8,111,"San Juan County, CO",San Juan County, CO,2011,522,461,61,11.7
8,113,"San Miguel County, CO",San Miguel County, CO,2011,4885,4492,393,8
8,115,"Sedgwick County, CO",Sedgwick County, CO,2011,1096,1009,87,7.9
8,117,"Summit County, CO",Summit County, CO,2011,19255,18003,1252,6.5
8,119,"Teller County, CO",Teller County, CO,2011,12154,11024,1130,9.3
8,121,"Washington County, CO",Washington County, CO,2011,2589,2448,141,5.4
8,123,"Weld County, CO",Weld County, CO,2011,134285,122737,11548,8.6
8,125,"Yuma County, CO",Yuma County, CO,2011,4962,4701,261,5.3
9,1,"Fairfield County, CT",Fairfield County, CT,2011,478150,439015,39135,8.2
9,3,"Hartford County, CT",Hartford County, CT,2011,478915,435028,43887,9.2
9,5,"Litchfield County, CT",Litchfield County, CT,2011,107856,99190,8666,8
9,7,"Middlesex County, CT",Middlesex County, CT,2011,93285,86318,6967,7.5
9,9,"New Haven County, CT",New Haven County, CT,2011,462506,417636,44870,9.7
9,11,"New London County, CT",New London County, CT,2011,143690,131015,12675,8.8
9,13,"Tolland County, CT",Tolland County, CT,2011,85874,79551,6323,7.4
9,15,"Windham County, CT",Windham County, CT,2011,64500,58214,6286,9.7
10,1,"Kent County, DE",Kent County, DE,2011,74035,67970,6065,8.2
10,3,"New Castle County, DE",New Castle County, DE,2011,277295,257163,20132,7.3
10,5,"Sussex County, DE",Sussex County, DE,2011,92016,84953,7063,7.7
11,1,District of Columbia,District of Columbia,,2011,350778,315171,35607,10.2
12,1,"Alachua County, FL",Alachua County, FL,2011,129027,119251,9776,7.6
12,3,"Baker County, FL",Baker County, FL,2011,11506,10333,1173,10.2
12,5,"Bay County, FL",Bay County, FL,2011,87205,78311,8894,10.2
12,7,"Bradford County, FL",Bradford County, FL,2011,11507,10462,1045,9.1
12,9,"Brevard County, FL",Brevard County, FL,2011,265213,236336,28877,10.9
12,11,"Broward County, FL",Broward County, FL,2011,951445,861686,89759,9.4
12,13,"Calhoun County, FL",Calhoun County, FL,2011,5242,4698,544,10.4
12,15,"Charlotte County, FL",Charlotte County, FL,2011,65722,58308,7414,11.3
12,17,"Citrus County, FL",Citrus County, FL,2011,52057,45546,6511,12.5
12,19,"Clay County, FL",Clay County, FL,2011,96166,87408,8758,9.1
12,21,"Collier County, FL",Collier County, FL,2011,148810,133729,15081,10.1
12,23,"Columbia County, FL",Columbia County, FL,2011,28242,25337,2905,10.3
12,27,"DeSoto County, FL",DeSoto County, FL,2011,13884,12447,1437,10.4
12,29,"Dixie County, FL",Dixie County, FL,2011,5754,5047,707,12.3
12,31,"Duval County, FL",Duval County, FL,2011,456441,409556,46885,10.3
12,33,"Escambia County, FL",Escambia County, FL,2011,140774,127131,13643,9.7
12,35,"Flagler County, FL",Flagler County, FL,2011,41940,37167,4773,11.4
12,37,"Franklin County, FL",Franklin County, FL,2011,5051,4665,386,7.6
12,39,"Gadsden County, FL",Gadsden County, FL,2011,19614,17342,2272,11.6
12,41,"Gilchrist County, FL",Gilchrist County, FL,2011,6857,6151,706,10.3
12,43,"Glades County, FL",Glades County, FL,2011,5292,4788,504,9.5
12,45,"Gulf County, FL",Gulf County, FL,2011,6241,5638,603,9.7
12,47,"Hamilton County, FL",Hamilton County, FL,2011,4898,4389,509,10.4
12,49,"Hardee County, FL",Hardee County, FL,2011,11916,10718,1198,10.1
12,51,"Hendry County, FL",Hendry County, FL,2011,17971,15482,2489,13.9
12,53,"Hernando County, FL",Hernando County, FL,2011,66199,57925,8274,12.5
12,55,"Highlands County, FL",Highlands County, FL,2011,38151,33773,4378,11.5
12,57,"Hillsborough County, FL",Hillsborough County, FL,2011,661540,598119,63421,9.6
12,59,"Holmes County, FL",Holmes County, FL,2011,7195,6488,707,9.8
12,61,"Indian River County, FL",Indian River County, FL,2011,61940,54097,7843,12.7
12,63,"Jackson County, FL",Jackson County, FL,2011,18260,16531,1729,9.5
12,65,"Jefferson County, FL",Jefferson County, FL,2011,5918,5323,595,10.1
12,67,"Lafayette County, FL",Lafayette County, FL,2011,3636,3409,227,6.2
12,69,"Lake County, FL",Lake County, FL,2011,133860,119672,14188,10.6
12,71,"Lee County, FL",Lee County, FL,2011,287064,255884,31180,10.9
12,73,"Leon County, FL",Leon County, FL,2011,149969,138321,11648,7.8
12,75,"Levy County, FL",Levy County, FL,2011,16974,15125,1849,10.9
12,77,"Liberty County, FL",Liberty County, FL,2011,2862,2600,262,9.2
12,79,"Madison County, FL",Madison County, FL,2011,8078,7303,775,9.6
12,81,"Manatee County, FL",Manatee County, FL,2011,148173,133384,14789,10
12,83,"Marion County, FL",Marion County, FL,2011,131031,114905,16126,12.3
12,85,"Martin County, FL",Martin County, FL,2011,66822,60208,6614,9.9
12,86,"Miami-Dade County, FL",Miami-Dade County, FL,2011,1255105,1137041,118064,9.4
12,87,"Monroe County, FL",Monroe County, FL,2011,42781,39791,2990,7
12,89,"Nassau County, FL",Nassau County, FL,2011,36018,32556,3462,9.6
12,91,"Okaloosa County, FL",Okaloosa County, FL,2011,90913,83806,7107,7.8
12,93,"Okeechobee County, FL",Okeechobee County, FL,2011,17822,15695,2127,11.9
12,95,"Orange County, FL",Orange County, FL,2011,642178,579251,62927,9.8
12,97,"Osceola County, FL",Osceola County, FL,2011,140286,124469,15817,11.3
12,99,"Palm Beach County, FL",Palm Beach County, FL,2011,652697,587173,65524,10
12,101,"Pasco County, FL",Pasco County, FL,2011,206715,184347,22368,10.8
12,103,"Pinellas County, FL",Pinellas County, FL,2011,463993,418950,45043,9.7
12,105,"Polk County, FL",Polk County, FL,2011,276920,245740,31180,11.3
12,107,"Putnam County, FL",Putnam County, FL,2011,29776,25968,3808,12.8
12,109,"St. Johns County, FL",St. Johns County, FL,2011,101402,93552,7850,7.7
12,111,"St. Lucie County, FL",St. Lucie County, FL,2011,128670,112473,16197,12.6
12,113,"Santa Rosa County, FL",Santa Rosa County, FL,2011,72675,66399,6276,8.6
12,115,"Sarasota County, FL",Sarasota County, FL,2011,166864,149796,17068,10.2
12,117,"Seminole County, FL",Seminole County, FL,2011,230621,208447,22174,9.6
12,119,"Sumter County, FL",Sumter County, FL,2011,26041,22876,3165,12.2
12,121,"Suwannee County, FL",Suwannee County, FL,2011,18870,17125,1745,9.2
12,123,"Taylor County, FL",Taylor County, FL,2011,9444,8493,951,10.1
12,125,"Union County, FL",Union County, FL,2011,5178,4754,424,8.2
12,127,"Volusia County, FL",Volusia County, FL,2011,237832,211132,26700,11.2
12,129,"Wakulla County, FL",Wakulla County, FL,2011,14604,13398,1206,8.3
12,131,"Walton County, FL",Walton County, FL,2011,26285,24050,2235,8.5
12,133,"Washington County, FL",Washington County, FL,2011,10412,9369,1043,10
13,1,"Appling County, GA",Appling County, GA,2011,8875,7778,1097,12.4
13,3,"Atkinson County, GA",Atkinson County, GA,2011,3495,3047,448,12.8
13,5,"Bacon County, GA",Bacon County, GA,2011,4508,4035,473,10.5
13,7,"Baker County, GA",Baker County, GA,2011,1172,1036,136,11.6
13,9,"Baldwin County, GA",Baldwin County, GA,2011,18617,16054,2563,13.8
13,11,"Banks County, GA",Banks County, GA,2011,8506,7720,786,9.2
13,13,"Barrow County, GA",Barrow County, GA,2011,34618,31174,3444,9.9
13,15,"Bartow County, GA",Bartow County, GA,2011,47746,42279,5467,11.5
13,17,"Ben Hill County, GA",Ben Hill County, GA,2011,6254,5279,975,15.6
13,19,"Berrien County, GA",Berrien County, GA,2011,7868,6886,982,12.5
13,21,"Bibb County, GA",Bibb County, GA,2011,71223,63035,8188,11.5
13,23,"Bleckley County, GA",Bleckley County, GA,2011,5492,4759,733,13.3
13,25,"Brantley County, GA",Brantley County, GA,2011,7463,6480,983,13.2
13,27,"Brooks County, GA",Brooks County, GA,2011,7066,6359,707,10
13,29,"Bryan County, GA",Bryan County, GA,2011,14722,13344,1378,9.4
13,31,"Bulloch County, GA",Bulloch County, GA,2011,33499,29978,3521,10.5
13,33,"Burke County, GA",Burke County, GA,2011,9953,8690,1263,12.7
13,35,"Butts County, GA",Butts County, GA,2011,10458,9270,1188,11.4
13,37,"Calhoun County, GA",Calhoun County, GA,2011,2522,2310,212,8.4
13,39,"Camden County, GA",Camden County, GA,2011,21154,19133,2021,9.6
13,43,"Candler County, GA",Candler County, GA,2011,5033,4549,484,9.6
13,45,"Carroll County, GA",Carroll County, GA,2011,51917,46021,5896,11.4
13,47,"Catoosa County, GA",Catoosa County, GA,2011,32062,29433,2629,8.2
13,49,"Charlton County, GA",Charlton County, GA,2011,4965,4437,528,10.6
13,51,"Chatham County, GA",Chatham County, GA,2011,129639,116650,12989,10
13,53,"Chattahoochee County, GA",Chattahoochee County, GA,2011,2369,2095,274,11.6
13,55,"Chattooga County, GA",Chattooga County, GA,2011,10578,9411,1167,11
13,57,"Cherokee County, GA",Cherokee County, GA,2011,113843,104542,9301,8.2
13,59,"Clarke County, GA",Clarke County, GA,2011,57177,51856,5321,9.3
13,61,"Clay County, GA",Clay County, GA,2011,1066,935,131,12.3
13,63,"Clayton County, GA",Clayton County, GA,2011,126983,109948,17035,13.4
13,65,"Clinch County, GA",Clinch County, GA,2011,2889,2572,317,11
13,67,"Cobb County, GA",Cobb County, GA,2011,384688,350725,33963,8.8
13,69,"Coffee County, GA",Coffee County, GA,2011,17605,15336,2269,12.9
13,71,"Colquitt County, GA",Colquitt County, GA,2011,21236,19217,2019,9.5
13,73,"Columbia County, GA",Columbia County, GA,2011,63320,58667,4653,7.3
13,75,"Cook County, GA",Cook County, GA,2011,7602,6746,856,11.3
13,77,"Coweta County, GA",Coweta County, GA,2011,65009,59123,5886,9.1
13,79,"Crawford County, GA",Crawford County, GA,2011,5807,5181,626,10.8
13,81,"Crisp County, GA",Crisp County, GA,2011,9203,7923,1280,13.9
13,83,"Dade County, GA",Dade County, GA,2011,8365,7697,668,8
13,85,"Dawson County, GA",Dawson County, GA,2011,10882,9779,1103,10.1
13,87,"Decatur County, GA",Decatur County, GA,2011,12066,10619,1447,12
13,89,"DeKalb County, GA",DeKalb County, GA,2011,366603,327936,38667,10.5
13,91,"Dodge County, GA",Dodge County, GA,2011,8292,7274,1018,12.3
13,93,"Dooly County, GA",Dooly County, GA,2011,4789,4164,625,13.1
13,95,"Dougherty County, GA",Dougherty County, GA,2011,41256,36235,5021,12.2
13,97,"Douglas County, GA",Douglas County, GA,2011,66989,59707,7282,10.9
13,99,"Early County, GA",Early County, GA,2011,4449,3938,511,11.5
13,101,"Echols County, GA",Echols County, GA,2011,1879,1727,152,8.1
13,103,"Effingham County, GA",Effingham County, GA,2011,25639,23251,2388,9.3
13,105,"Elbert County, GA",Elbert County, GA,2011,8796,7378,1418,16.1
13,107,"Emanuel County, GA",Emanuel County, GA,2011,9162,7944,1218,13.3
13,109,"Evans County, GA",Evans County, GA,2011,4809,4370,439,9.1
13,111,"Fannin County, GA",Fannin County, GA,2011,10273,9113,1160,11.3
13,113,"Fayette County, GA",Fayette County, GA,2011,53224,48960,4264,8
13,115,"Floyd County, GA",Floyd County, GA,2011,44852,39440,5412,12.1
13,117,"Forsyth County, GA",Forsyth County, GA,2011,91061,84314,6747,7.4
13,119,"Franklin County, GA",Franklin County, GA,2011,9751,8566,1185,12.2
13,121,"Fulton County, GA",Fulton County, GA,2011,498861,448034,50827,10.2
13,123,"Gilmer County, GA",Gilmer County, GA,2011,12372,10917,1455,11.8
13,125,"Glascock County, GA",Glascock County, GA,2011,1335,1193,142,10.6
13,127,"Glynn County, GA",Glynn County, GA,2011,38256,34267,3989,10.4
13,129,"Gordon County, GA",Gordon County, GA,2011,26267,23198,3069,11.7
13,131,"Grady County, GA",Grady County, GA,2011,10847,9817,1030,9.5
13,133,"Greene County, GA",Greene County, GA,2011,6379,5592,787,12.3
13,135,"Gwinnett County, GA",Gwinnett County, GA,2011,427145,389936,37209,8.7
13,137,"Habersham County, GA",Habersham County, GA,2011,18337,16411,1926,10.5
13,139,"Hall County, GA",Hall County, GA,2011,87726,79953,7773,8.9
13,141,"Hancock County, GA",Hancock County, GA,2011,2961,2375,586,19.8
13,143,"Haralson County, GA",Haralson County, GA,2011,12255,10833,1422,11.6
13,145,"Harris County, GA",Harris County, GA,2011,16399,15184,1215,7.4
13,147,"Hart County, GA",Hart County, GA,2011,11146,9898,1248,11.2
13,149,"Heard County, GA",Heard County, GA,2011,5169,4584,585,11.3
13,151,"Henry County, GA",Henry County, GA,2011,102687,92085,10602,10.3
13,153,"Houston County, GA",Houston County, GA,2011,68352,62512,5840,8.5
13,155,"Irwin County, GA",Irwin County, GA,2011,3541,3054,487,13.8
13,157,"Jackson County, GA",Jackson County, GA,2011,28906,26135,2771,9.6
13,159,"Jasper County, GA",Jasper County, GA,2011,6796,6047,749,11
13,161,"Jeff Davis County, GA",Jeff Davis County, GA,2011,6512,5692,820,12.6
13,163,"Jefferson County, GA",Jefferson County, GA,2011,7121,6177,944,13.3
13,165,"Jenkins County, GA",Jenkins County, GA,2011,3206,2746,460,14.3
13,167,"Johnson County, GA",Johnson County, GA,2011,4165,3703,462,11.1
13,169,"Jones County, GA",Jones County, GA,2011,13817,12544,1273,9.2
13,171,"Lamar County, GA",Lamar County, GA,2011,8116,7002,1114,13.7
13,173,"Lanier County, GA",Lanier County, GA,2011,3951,3536,415,10.5
13,175,"Laurens County, GA",Laurens County, GA,2011,20302,17493,2809,13.8
13,177,"Lee County, GA",Lee County, GA,2011,14330,13119,1211,8.5
13,179,"Liberty County, GA",Liberty County, GA,2011,27588,25015,2573,9.3
13,181,"Lincoln County, GA",Lincoln County, GA,2011,3636,3216,420,11.6
13,183,"Long County, GA",Long County, GA,2011,6375,5809,566,8.9
13,185,"Lowndes County, GA",Lowndes County, GA,2011,51359,46277,5082,9.9
13,187,"Lumpkin County, GA",Lumpkin County, GA,2011,14884,13429,1455,9.8
13,189,"McDuffie County, GA",McDuffie County, GA,2011,9405,8150,1255,13.3
13,191,"McIntosh County, GA",McIntosh County, GA,2011,6188,5530,658,10.6
13,193,"Macon County, GA",Macon County, GA,2011,5281,4550,731,13.8
13,195,"Madison County, GA",Madison County, GA,2011,13222,11885,1337,10.1
13,197,"Marion County, GA",Marion County, GA,2011,3681,3297,384,10.4
13,199,"Meriwether County, GA",Meriwether County, GA,2011,9244,8009,1235,13.4
13,201,"Miller County, GA",Miller County, GA,2011,2737,2486,251,9.2
13,205,"Mitchell County, GA",Mitchell County, GA,2011,9523,8568,955,10
13,207,"Monroe County, GA",Monroe County, GA,2011,12739,11503,1236,9.7
13,209,"Montgomery County, GA",Montgomery County, GA,2011,3913,3397,516,13.2
13,211,"Morgan County, GA",Morgan County, GA,2011,8639,7771,868,10
13,213,"Murray County, GA",Murray County, GA,2011,17062,14692,2370,13.9
13,215,"Muscogee County, GA",Muscogee County, GA,2011,82863,74559,8304,10
13,217,"Newton County, GA",Newton County, GA,2011,48399,42424,5975,12.3
13,219,"Oconee County, GA",Oconee County, GA,2011,16910,15727,1183,7
13,221,"Oglethorpe County, GA",Oglethorpe County, GA,2011,6999,6319,680,9.7
13,223,"Paulding County, GA",Paulding County, GA,2011,74316,67219,7097,9.5
13,225,"Peach County, GA",Peach County, GA,2011,12693,11189,1504,11.8
13,227,"Pickens County, GA",Pickens County, GA,2011,14063,12582,1481,10.5
13,229,"Pierce County, GA",Pierce County, GA,2011,8099,7236,863,10.7
13,231,"Pike County, GA",Pike County, GA,2011,8437,7577,860,10.2
13,233,"Polk County, GA",Polk County, GA,2011,18679,16532,2147,11.5
13,235,"Pulaski County, GA",Pulaski County, GA,2011,4486,4055,431,9.6
13,237,"Putnam County, GA",Putnam County, GA,2011,8667,7541,1126,13
13,239,"Quitman County, GA",Quitman County, GA,2011,979,879,100,10.2
13,241,"Rabun County, GA",Rabun County, GA,2011,7034,6163,871,12.4
13,243,"Randolph County, GA",Randolph County, GA,2011,2945,2569,376,12.8
13,245,"Richmond County, GA",Richmond County, GA,2011,88510,78559,9951,11.2
13,247,"Rockdale County, GA",Rockdale County, GA,2011,42258,37516,4742,11.2
13,249,"Schley County, GA",Schley County, GA,2011,2162,1914,248,11.5
13,251,"Screven County, GA",Screven County, GA,2011,5768,4857,911,15.8
13,253,"Seminole County, GA",Seminole County, GA,2011,3272,2860,412,12.6
13,255,"Spalding County, GA",Spalding County, GA,2011,28573,24569,4004,14
13,257,"Stephens County, GA",Stephens County, GA,2011,11743,10340,1403,11.9
13,259,"Stewart County, GA",Stewart County, GA,2011,2337,2108,229,9.8
13,261,"Sumter County, GA",Sumter County, GA,2011,13933,12183,1750,12.6
13,263,"Talbot County, GA",Talbot County, GA,2011,2918,2611,307,10.5
13,265,"Taliaferro County, GA",Taliaferro County, GA,2011,618,521,97,15.7
13,267,"Tattnall County, GA",Tattnall County, GA,2011,9874,9005,869,8.8
13,269,"Taylor County, GA",Taylor County, GA,2011,3179,2720,459,14.4
13,271,"Telfair County, GA",Telfair County, GA,2011,5282,4583,699,13.2
13,273,"Terrell County, GA",Terrell County, GA,2011,3850,3388,462,12
13,275,"Thomas County, GA",Thomas County, GA,2011,18338,16437,1901,10.4
13,277,"Tift County, GA",Tift County, GA,2011,18942,16652,2290,12.1
13,279,"Toombs County, GA",Toombs County, GA,2011,12433,10766,1667,13.4
13,281,"Towns County, GA",Towns County, GA,2011,4357,3811,546,12.5
13,283,"Treutlen County, GA",Treutlen County, GA,2011,2989,2592,397,13.3
13,285,"Troup County, GA",Troup County, GA,2011,34505,30705,3800,11
13,287,"Turner County, GA",Turner County, GA,2011,3598,3084,514,14.3
13,289,"Twiggs County, GA",Twiggs County, GA,2011,3255,2751,504,15.5
13,291,"Union County, GA",Union County, GA,2011,9480,8517,963,10.2
13,293,"Upson County, GA",Upson County, GA,2011,12013,10621,1392,11.6
13,295,"Walker County, GA",Walker County, GA,2011,31064,28025,3039,9.8
13,297,"Walton County, GA",Walton County, GA,2011,41220,36929,4291,10.4
13,299,"Ware County, GA",Ware County, GA,2011,15280,13556,1724,11.3
13,301,"Warren County, GA",Warren County, GA,2011,2648,2209,439,16.6
13,303,"Washington County, GA",Washington County, GA,2011,8116,7082,1034,12.7
13,305,"Wayne County, GA",Wayne County, GA,2011,12504,10985,1519,12.1
13,307,"Webster County, GA",Webster County, GA,2011,1067,945,122,11.4
13,309,"Wheeler County, GA",Wheeler County, GA,2011,1981,1690,291,14.7
13,311,"White County, GA",White County, GA,2011,13169,11861,1308,9.9
13,313,"Whitfield County, GA",Whitfield County, GA,2011,47462,41846,5616,11.8
13,315,"Wilcox County, GA",Wilcox County, GA,2011,2933,2558,375,12.8
13,317,"Wilkes County, GA",Wilkes County, GA,2011,3931,3384,547,13.9
13,319,"Wilkinson County, GA",Wilkinson County, GA,2011,3775,3288,487,12.9
13,321,"Worth County, GA",Worth County, GA,2011,9795,8669,1126,11.5
15,1,"Hawaii County, HI",Hawaii County, HI,2011,88675,79952,8723,9.8
15,3,"Honolulu County/city, HI",Honolulu County/city, HI,2011,456169,429374,26795,5.9
15,7,"Kauai County, HI",Kauai County, HI,2011,34904,31869,3035,8.7
15,9,"Maui County, HI",Maui County, HI,2011,80507,74125,6382,7.9
16,1,"Ada County, ID",Ada County, ID,2011,200187,185482,14705,7.3
16,3,"Adams County, ID",Adams County, ID,2011,1744,1432,312,17.9
16,5,"Bannock County, ID",Bannock County, ID,2011,41041,37956,3085,7.5
16,7,"Bear Lake County, ID",Bear Lake County, ID,2011,2921,2743,178,6.1
16,9,"Benewah County, ID",Benewah County, ID,2011,4149,3597,552,13.3
16,11,"Bingham County, ID",Bingham County, ID,2011,22836,21207,1629,7.1
16,13,"Blaine County, ID",Blaine County, ID,2011,11870,10840,1030,8.7
16,15,"Boise County, ID",Boise County, ID,2011,3058,2746,312,10.2
16,17,"Bonner County, ID",Bonner County, ID,2011,19037,16685,2352,12.4
16,19,"Bonneville County, ID",Bonneville County, ID,2011,49315,45896,3419,6.9
16,21,"Boundary County, ID",Boundary County, ID,2011,5383,4760,623,11.6
16,23,"Butte County, ID",Butte County, ID,2011,1324,1216,108,8.2
16,25,"Camas County, ID",Camas County, ID,2011,639,560,79,12.4
16,27,"Canyon County, ID",Canyon County, ID,2011,85470,76447,9023,10.6
16,29,"Caribou County, ID",Caribou County, ID,2011,3883,3593,290,7.5
16,31,"Cassia County, ID",Cassia County, ID,2011,11191,10453,738,6.6
16,33,"Clark County, ID",Clark County, ID,2011,516,470,46,8.9
16,35,"Clearwater County, ID",Clearwater County, ID,2011,3354,2895,459,13.7
16,37,"Custer County, ID",Custer County, ID,2011,2300,2117,183,8
16,39,"Elmore County, ID",Elmore County, ID,2011,10998,10086,912,8.3
16,41,"Franklin County, ID",Franklin County, ID,2011,6247,5908,339,5.4
16,43,"Fremont County, ID",Fremont County, ID,2011,6703,6184,519,7.7
16,45,"Gem County, ID",Gem County, ID,2011,7704,6871,833,10.8
16,47,"Gooding County, ID",Gooding County, ID,2011,8364,7799,565,6.8
16,49,"Idaho County, ID",Idaho County, ID,2011,6683,5858,825,12.3
16,51,"Jefferson County, ID",Jefferson County, ID,2011,12506,11638,868,6.9
16,53,"Jerome County, ID",Jerome County, ID,2011,11107,10274,833,7.5
16,55,"Kootenai County, ID",Kootenai County, ID,2011,69295,62263,7032,10.1
16,57,"Latah County, ID",Latah County, ID,2011,19244,18032,1212,6.3
16,59,"Lemhi County, ID",Lemhi County, ID,2011,3666,3289,377,10.3
16,61,"Lewis County, ID",Lewis County, ID,2011,1554,1457,97,6.2
16,63,"Lincoln County, ID",Lincoln County, ID,2011,2680,2360,320,11.9
16,65,"Madison County, ID",Madison County, ID,2011,17896,16950,946,5.3
16,67,"Minidoka County, ID",Minidoka County, ID,2011,10560,9826,734,7
16,69,"Nez Perce County, ID",Nez Perce County, ID,2011,20083,18805,1278,6.4
16,71,"Oneida County, ID",Oneida County, ID,2011,2016,1899,117,5.8
16,73,"Owyhee County, ID",Owyhee County, ID,2011,4885,4673,212,4.3
16,75,"Payette County, ID",Payette County, ID,2011,11159,10156,1003,9
16,77,"Power County, ID",Power County, ID,2011,3927,3582,345,8.8
16,79,"Shoshone County, ID",Shoshone County, ID,2011,5511,4712,799,14.5
16,81,"Teton County, ID",Teton County, ID,2011,5325,4966,359,6.7
16,83,"Twin Falls County, ID",Twin Falls County, ID,2011,37466,34519,2947,7.9
16,85,"Valley County, ID",Valley County, ID,2011,4653,3996,657,14.1
16,87,"Washington County, ID",Washington County, ID,2011,4733,4271,462,9.8
17,1,"Adams County, IL",Adams County, IL,2011,34382,32007,2375,6.9
17,3,"Alexander County, IL",Alexander County, IL,2011,2890,2516,374,12.9
17,5,"Bond County, IL",Bond County, IL,2011,8476,7695,781,9.2
17,7,"Boone County, IL",Boone County, IL,2011,27177,23972,3205,11.8
17,9,"Brown County, IL",Brown County, IL,2011,2590,2429,161,6.2
17,11,"Bureau County, IL",Bureau County, IL,2011,18720,16883,1837,9.8
17,13,"Calhoun County, IL",Calhoun County, IL,2011,2502,2254,248,9.9
17,15,"Carroll County, IL",Carroll County, IL,2011,8301,7554,747,9
17,17,"Cass County, IL",Cass County, IL,2011,6906,6344,562,8.1
17,19,"Champaign County, IL",Champaign County, IL,2011,105685,97465,8220,7.8
17,21,"Christian County, IL",Christian County, IL,2011,16877,15271,1606,9.5
17,23,"Clark County, IL",Clark County, IL,2011,8115,7273,842,10.4
17,25,"Clay County, IL",Clay County, IL,2011,6685,5978,707,10.6
17,27,"Clinton County, IL",Clinton County, IL,2011,20696,19304,1392,6.7
17,29,"Coles County, IL",Coles County, IL,2011,24783,22454,2329,9.4
17,31,"Cook County, IL",Cook County, IL,2011,2636492,2360934,275558,10.5
17,33,"Crawford County, IL",Crawford County, IL,2011,10819,10029,790,7.3
17,35,"Cumberland County, IL",Cumberland County, IL,2011,5939,5426,513,8.6
17,37,"DeKalb County, IL",DeKalb County, IL,2011,55651,50482,5169,9.3
17,39,"De Witt County, IL",De Witt County, IL,2011,8685,7959,726,8.4
17,41,"Douglas County, IL",Douglas County, IL,2011,10132,9305,827,8.2
17,43,"DuPage County, IL",DuPage County, IL,2011,501960,460854,41106,8.2
17,45,"Edgar County, IL",Edgar County, IL,2011,9332,8349,983,10.5
17,47,"Edwards County, IL",Edwards County, IL,2011,3135,2881,254,8.1
17,49,"Effingham County, IL",Effingham County, IL,2011,18633,17365,1268,6.8
17,51,"Fayette County, IL",Fayette County, IL,2011,11179,10126,1053,9.4
17,53,"Ford County, IL",Ford County, IL,2011,6985,6375,610,8.7
17,55,"Franklin County, IL",Franklin County, IL,2011,17604,15640,1964,11.2
17,57,"Fulton County, IL",Fulton County, IL,2011,17414,15594,1820,10.5
17,59,"Gallatin County, IL",Gallatin County, IL,2011,2575,2347,228,8.9
17,61,"Greene County, IL",Greene County, IL,2011,6705,6117,588,8.8
17,63,"Grundy County, IL",Grundy County, IL,2011,25733,22470,3263,12.7
17,65,"Hamilton County, IL",Hamilton County, IL,2011,3912,3576,336,8.6
17,67,"Hancock County, IL",Hancock County, IL,2011,9625,8741,884,9.2
17,69,"Hardin County, IL",Hardin County, IL,2011,1748,1560,188,10.8
17,71,"Henderson County, IL",Henderson County, IL,2011,3855,3547,308,8
17,73,"Henry County, IL",Henry County, IL,2011,26495,24412,2083,7.9
17,75,"Iroquois County, IL",Iroquois County, IL,2011,15720,14277,1443,9.2
17,77,"Jackson County, IL",Jackson County, IL,2011,29625,27266,2359,8
17,79,"Jasper County, IL",Jasper County, IL,2011,5003,4608,395,7.9
17,81,"Jefferson County, IL",Jefferson County, IL,2011,18171,16477,1694,9.3
17,83,"Jersey County, IL",Jersey County, IL,2011,11580,10546,1034,8.9
17,85,"Jo Daviess County, IL",Jo Daviess County, IL,2011,12129,11168,961,7.9
17,87,"Johnson County, IL",Johnson County, IL,2011,4390,3877,513,11.7
17,89,"Kane County, IL",Kane County, IL,2011,267179,241117,26062,9.8
17,91,"Kankakee County, IL",Kankakee County, IL,2011,56857,50368,6489,11.4
17,93,"Kendall County, IL",Kendall County, IL,2011,62638,56793,5845,9.3
17,95,"Knox County, IL",Knox County, IL,2011,24853,22664,2189,8.8
17,97,"Lake County, IL",Lake County, IL,2011,368533,336077,32456,8.8
17,99,"LaSalle County, IL",LaSalle County, IL,2011,60832,54336,6496,10.7
17,101,"Lawrence County, IL",Lawrence County, IL,2011,6566,5873,693,10.6
17,103,"Lee County, IL",Lee County, IL,2011,18846,17122,1724,9.1
17,105,"Livingston County, IL",Livingston County, IL,2011,18824,17236,1588,8.4
17,107,"Logan County, IL",Logan County, IL,2011,13716,12650,1066,7.8
17,109,"McDonough County, IL",McDonough County, IL,2011,15146,13943,1203,7.9
17,111,"McHenry County, IL",McHenry County, IL,2011,166740,150286,16454,9.9
17,113,"McLean County, IL",McLean County, IL,2011,95315,89007,6308,6.6
17,115,"Macon County, IL",Macon County, IL,2011,54901,49409,5492,10
17,117,"Macoupin County, IL",Macoupin County, IL,2011,24749,22349,2400,9.7
17,119,"Madison County, IL",Madison County, IL,2011,137703,125383,12320,8.9
17,121,"Marion County, IL",Marion County, IL,2011,19105,17199,1906,10
17,123,"Marshall County, IL",Marshall County, IL,2011,6336,5778,558,8.8
17,125,"Mason County, IL",Mason County, IL,2011,7169,6406,763,10.6
17,127,"Massac County, IL",Massac County, IL,2011,7119,6487,632,8.9
17,129,"Menard County, IL",Menard County, IL,2011,7133,6622,511,7.2
17,131,"Mercer County, IL",Mercer County, IL,2011,8831,8095,736,8.3
17,133,"Monroe County, IL",Monroe County, IL,2011,18115,16895,1220,6.7
17,135,"Montgomery County, IL",Montgomery County, IL,2011,13648,12028,1620,11.9
17,137,"Morgan County, IL",Morgan County, IL,2011,18142,16674,1468,8.1
17,139,"Moultrie County, IL",Moultrie County, IL,2011,7458,6887,571,7.7
17,141,"Ogle County, IL",Ogle County, IL,2011,27419,24289,3130,11.4
17,143,"Peoria County, IL",Peoria County, IL,2011,96172,87307,8865,9.2
17,145,"Perry County, IL",Perry County, IL,2011,9460,8497,963,10.2
17,147,"Piatt County, IL",Piatt County, IL,2011,8814,8193,621,7
17,149,"Pike County, IL",Pike County, IL,2011,7910,7278,632,8
17,151,"Pope County, IL",Pope County, IL,2011,1977,1796,181,9.2
17,153,"Pulaski County, IL",Pulaski County, IL,2011,2354,2075,279,11.9
17,155,"Putnam County, IL",Putnam County, IL,2011,3197,2869,328,10.3
17,157,"Randolph County, IL",Randolph County, IL,2011,14800,13575,1225,8.3
17,159,"Richland County, IL",Richland County, IL,2011,7801,7161,640,8.2
17,161,"Rock Island County, IL",Rock Island County, IL,2011,75965,69480,6485,8.5
17,163,"St. Clair County, IL",St. Clair County, IL,2011,132823,119863,12960,9.8
17,165,"Saline County, IL",Saline County, IL,2011,11649,10544,1105,9.5
17,167,"Sangamon County, IL",Sangamon County, IL,2011,108915,100811,8104,7.4
17,169,"Schuyler County, IL",Schuyler County, IL,2011,3769,3468,301,8
17,171,"Scott County, IL",Scott County, IL,2011,2843,2613,230,8.1
17,173,"Shelby County, IL",Shelby County, IL,2011,11011,10012,999,9.1
17,175,"Stark County, IL",Stark County, IL,2011,2967,2713,254,8.6
17,177,"Stephenson County, IL",Stephenson County, IL,2011,24206,21833,2373,9.8
17,179,"Tazewell County, IL",Tazewell County, IL,2011,71516,65587,5929,8.3
17,181,"Union County, IL",Union County, IL,2011,7748,6852,896,11.6
17,183,"Vermilion County, IL",Vermilion County, IL,2011,37486,33769,3717,9.9
17,185,"Wabash County, IL",Wabash County, IL,2011,5815,5293,522,9
17,187,"Warren County, IL",Warren County, IL,2011,9130,8466,664,7.3
17,189,"Washington County, IL",Washington County, IL,2011,8710,8139,571,6.6
17,191,"Wayne County, IL",Wayne County, IL,2011,8210,7547,663,8.1
17,193,"White County, IL",White County, IL,2011,7422,6835,587,7.9
17,195,"Whiteside County, IL",Whiteside County, IL,2011,29655,26848,2807,9.5
17,197,"Will County, IL",Will County, IL,2011,354427,316753,37674,10.6
17,199,"Williamson County, IL",Williamson County, IL,2011,32322,29390,2932,9.1
17,201,"Winnebago County, IL",Winnebago County, IL,2011,147422,129943,17479,11.9
17,203,"Woodford County, IL",Woodford County, IL,2011,20514,19178,1336,6.5
18,1,"Adams County, IN",Adams County, IN,2011,16154,14891,1263,7.8
18,3,"Allen County, IN",Allen County, IN,2011,176124,159787,16337,9.3
18,5,"Bartholomew County, IN",Bartholomew County, IN,2011,40025,36982,3043,7.6
18,7,"Benton County, IN",Benton County, IN,2011,4644,4277,367,7.9
18,9,"Blackford County, IN",Blackford County, IN,2011,5624,4933,691,12.3
18,11,"Boone County, IN",Boone County, IN,2011,29815,27812,2003,6.7
18,13,"Brown County, IN",Brown County, IN,2011,7430,6746,684,9.2
18,15,"Carroll County, IN",Carroll County, IN,2011,10125,9282,843,8.3
18,17,"Cass County, IN",Cass County, IN,2011,18181,16467,1714,9.4
18,19,"Clark County, IN",Clark County, IN,2011,55551,50607,4944,8.9
18,21,"Clay County, IN",Clay County, IN,2011,12995,11646,1349,10.4
18,23,"Clinton County, IN",Clinton County, IN,2011,16749,15305,1444,8.6
18,25,"Crawford County, IN",Crawford County, IN,2011,4866,4289,577,11.9
18,27,"Daviess County, IN",Daviess County, IN,2011,14887,13978,909,6.1
18,29,"Dearborn County, IN",Dearborn County, IN,2011,25339,22898,2441,9.6
18,31,"Decatur County, IN",Decatur County, IN,2011,13014,11741,1273,9.8
18,33,"DeKalb County, IN",DeKalb County, IN,2011,20488,18501,1987,9.7
18,35,"Delaware County, IN",Delaware County, IN,2011,54650,49103,5547,10.2
18,37,"Dubois County, IN",Dubois County, IN,2011,21938,20606,1332,6.1
18,39,"Elkhart County, IN",Elkhart County, IN,2011,95377,85123,10254,10.8
18,41,"Fayette County, IN",Fayette County, IN,2011,9512,8317,1195,12.6
18,43,"Floyd County, IN",Floyd County, IN,2011,37767,34753,3014,8
18,45,"Fountain County, IN",Fountain County, IN,2011,8631,7803,828,9.6
18,47,"Franklin County, IN",Franklin County, IN,2011,11221,10094,1127,10
18,49,"Fulton County, IN",Fulton County, IN,2011,10200,9258,942,9.2
18,51,"Gibson County, IN",Gibson County, IN,2011,17283,16016,1267,7.3
18,53,"Grant County, IN",Grant County, IN,2011,33438,29968,3470,10.4
18,55,"Greene County, IN",Greene County, IN,2011,14180,12710,1470,10.4
18,57,"Hamilton County, IN",Hamilton County, IN,2011,148121,139512,8609,5.8
18,59,"Hancock County, IN",Hancock County, IN,2011,35797,32847,2950,8.2
18,61,"Harrison County, IN",Harrison County, IN,2011,18773,17095,1678,8.9
18,63,"Hendricks County, IN",Hendricks County, IN,2011,76018,70713,5305,7
18,65,"Henry County, IN",Henry County, IN,2011,21288,18838,2450,11.5
18,67,"Howard County, IN",Howard County, IN,2011,36051,32289,3762,10.4
18,69,"Huntington County, IN",Huntington County, IN,2011,19150,17270,1880,9.8
18,71,"Jackson County, IN",Jackson County, IN,2011,20549,18752,1797,8.7
18,73,"Jasper County, IN",Jasper County, IN,2011,16093,14633,1460,9.1
18,75,"Jay County, IN",Jay County, IN,2011,10528,9583,945,9
18,77,"Jefferson County, IN",Jefferson County, IN,2011,15170,13687,1483,9.8
18,79,"Jennings County, IN",Jennings County, IN,2011,13341,11804,1537,11.5
18,81,"Johnson County, IN",Johnson County, IN,2011,72053,66470,5583,7.7
18,83,"Knox County, IN",Knox County, IN,2011,18459,17084,1375,7.4
18,85,"Kosciusko County, IN",Kosciusko County, IN,2011,38972,35490,3482,8.9
18,87,"LaGrange County, IN",LaGrange County, IN,2011,16666,15168,1498,9
18,89,"Lake County, IN",Lake County, IN,2011,229310,207344,21966,9.6
18,91,"LaPorte County, IN",LaPorte County, IN,2011,50457,45219,5238,10.4
18,93,"Lawrence County, IN",Lawrence County, IN,2011,20791,18375,2416,11.6
18,95,"Madison County, IN",Madison County, IN,2011,58819,52409,6410,10.9
18,97,"Marion County, IN",Marion County, IN,2011,456016,410963,45053,9.9
18,99,"Marshall County, IN",Marshall County, IN,2011,23453,21231,2222,9.5
18,101,"Martin County, IN",Martin County, IN,2011,5345,4944,401,7.5
18,103,"Miami County, IN",Miami County, IN,2011,15937,14272,1665,10.4
18,105,"Monroe County, IN",Monroe County, IN,2011,67562,62474,5088,7.5
18,107,"Montgomery County, IN",Montgomery County, IN,2011,18713,17054,1659,8.9
18,109,"Morgan County, IN",Morgan County, IN,2011,34902,31637,3265,9.4
18,111,"Newton County, IN",Newton County, IN,2011,6989,6299,690,9.9
18,113,"Noble County, IN",Noble County, IN,2011,23132,20801,2331,10.1
18,115,"Ohio County, IN",Ohio County, IN,2011,3210,2905,305,9.5
18,117,"Orange County, IN",Orange County, IN,2011,8866,7817,1049,11.8
18,119,"Owen County, IN",Owen County, IN,2011,10137,8999,1138,11.2
18,121,"Parke County, IN",Parke County, IN,2011,7195,6443,752,10.5
18,123,"Perry County, IN",Perry County, IN,2011,9062,8237,825,9.1
18,125,"Pike County, IN",Pike County, IN,2011,6232,5745,487,7.8
18,127,"Porter County, IN",Porter County, IN,2011,82280,75558,6722,8.2
18,129,"Posey County, IN",Posey County, IN,2011,13421,12498,923,6.9
18,131,"Pulaski County, IN",Pulaski County, IN,2011,6401,5884,517,8.1
18,133,"Putnam County, IN",Putnam County, IN,2011,16596,14799,1797,10.8
18,135,"Randolph County, IN",Randolph County, IN,2011,13023,11672,1351,10.4
18,137,"Ripley County, IN",Ripley County, IN,2011,14938,13526,1412,9.5
18,139,"Rush County, IN",Rush County, IN,2011,8584,7766,818,9.5
18,141,"St. Joseph County, IN",St. Joseph County, IN,2011,130606,117386,13220,10.1
18,143,"Scott County, IN",Scott County, IN,2011,10378,9146,1232,11.9
18,145,"Shelby County, IN",Shelby County, IN,2011,22512,20380,2132,9.5
18,147,"Spencer County, IN",Spencer County, IN,2011,11032,10186,846,7.7
18,149,"Starke County, IN",Starke County, IN,2011,10332,9153,1179,11.4
18,151,"Steuben County, IN",Steuben County, IN,2011,18565,16902,1663,9
18,153,"Sullivan County, IN",Sullivan County, IN,2011,8891,8064,827,9.3
18,155,"Switzerland County, IN",Switzerland County, IN,2011,4987,4580,407,8.2
18,157,"Tippecanoe County, IN",Tippecanoe County, IN,2011,87456,80923,6533,7.5
18,159,"Tipton County, IN",Tipton County, IN,2011,7956,7240,716,9
18,161,"Union County, IN",Union County, IN,2011,3667,3343,324,8.8
18,163,"Vanderburgh County, IN",Vanderburgh County, IN,2011,92760,85342,7418,8
18,165,"Vermillion County, IN",Vermillion County, IN,2011,7647,6749,898,11.7
18,167,"Vigo County, IN",Vigo County, IN,2011,50515,45311,5204,10.3
18,169,"Wabash County, IN",Wabash County, IN,2011,15707,14205,1502,9.6
18,171,"Warren County, IN",Warren County, IN,2011,4271,3924,347,8.1
18,173,"Warrick County, IN",Warrick County, IN,2011,31119,28911,2208,7.1
18,175,"Washington County, IN",Washington County, IN,2011,13515,12081,1434,10.6
18,177,"Wayne County, IN",Wayne County, IN,2011,30992,27547,3445,11.1
18,179,"Wells County, IN",Wells County, IN,2011,14049,12892,1157,8.2
18,181,"White County, IN",White County, IN,2011,13108,11974,1134,8.7
18,183,"Whitley County, IN",Whitley County, IN,2011,17325,15709,1616,9.3
19,1,"Adair County, IA",Adair County, IA,2011,4096,3897,199,4.9
19,3,"Adams County, IA",Adams County, IA,2011,2209,2111,98,4.4
19,5,"Allamakee County, IA",Allamakee County, IA,2011,7745,7189,556,7.2
19,7,"Appanoose County, IA",Appanoose County, IA,2011,6053,5634,419,6.9
19,9,"Audubon County, IA",Audubon County, IA,2011,3363,3170,193,5.7
19,11,"Benton County, IA",Benton County, IA,2011,14118,13299,819,5.8
19,13,"Black Hawk County, IA",Black Hawk County, IA,2011,70918,66783,4135,5.8
19,15,"Boone County, IA",Boone County, IA,2011,14658,13931,727,5
19,17,"Bremer County, IA",Bremer County, IA,2011,13842,13238,604,4.4
19,19,"Buchanan County, IA",Buchanan County, IA,2011,11167,10535,632,5.7
19,21,"Buena Vista County, IA",Buena Vista County, IA,2011,11338,10827,511,4.5
19,23,"Butler County, IA",Butler County, IA,2011,8172,7761,411,5
19,25,"Calhoun County, IA",Calhoun County, IA,2011,4509,4252,257,5.7
19,27,"Carroll County, IA",Carroll County, IA,2011,11611,11143,468,4
19,29,"Cass County, IA",Cass County, IA,2011,7288,6854,434,6
19,31,"Cedar County, IA",Cedar County, IA,2011,10873,10312,561,5.2
19,33,"Cerro Gordo County, IA",Cerro Gordo County, IA,2011,24160,22679,1481,6.1
19,35,"Cherokee County, IA",Cherokee County, IA,2011,6936,6607,329,4.7
19,37,"Chickasaw County, IA",Chickasaw County, IA,2011,6490,6084,406,6.3
19,39,"Clarke County, IA",Clarke County, IA,2011,4686,4357,329,7
19,41,"Clay County, IA",Clay County, IA,2011,9252,8749,503,5.4
19,43,"Clayton County, IA",Clayton County, IA,2011,10341,9702,639,6.2
19,45,"Clinton County, IA",Clinton County, IA,2011,25839,24129,1710,6.6
19,47,"Crawford County, IA",Crawford County, IA,2011,8818,8401,417,4.7
19,49,"Dallas County, IA",Dallas County, IA,2011,38216,36585,1631,4.3
19,51,"Davis County, IA",Davis County, IA,2011,4187,3932,255,6.1
19,53,"Decatur County, IA",Decatur County, IA,2011,4343,4126,217,5
19,55,"Delaware County, IA",Delaware County, IA,2011,10251,9692,559,5.5
19,57,"Des Moines County, IA",Des Moines County, IA,2011,20304,18935,1369,6.7
19,59,"Dickinson County, IA",Dickinson County, IA,2011,9256,8673,583,6.3
19,61,"Dubuque County, IA",Dubuque County, IA,2011,54378,51630,2748,5.1
19,63,"Emmet County, IA",Emmet County, IA,2011,5787,5463,324,5.6
19,65,"Fayette County, IA",Fayette County, IA,2011,11040,10354,686,6.2
19,67,"Floyd County, IA",Floyd County, IA,2011,8291,7754,537,6.5
19,69,"Franklin County, IA",Franklin County, IA,2011,5970,5664,306,5.1
19,71,"Fremont County, IA",Fremont County, IA,2011,3967,3738,229,5.8
19,73,"Greene County, IA",Greene County, IA,2011,5189,4899,290,5.6
19,75,"Grundy County, IA",Grundy County, IA,2011,6703,6369,334,5
19,77,"Guthrie County, IA",Guthrie County, IA,2011,5690,5342,348,6.1
19,79,"Hamilton County, IA",Hamilton County, IA,2011,7468,6811,657,8.8
19,81,"Hancock County, IA",Hancock County, IA,2011,5938,5606,332,5.6
19,83,"Hardin County, IA",Hardin County, IA,2011,8986,8458,528,5.9
19,85,"Harrison County, IA",Harrison County, IA,2011,7818,7385,433,5.5
19,87,"Henry County, IA",Henry County, IA,2011,9829,9161,668,6.8
19,89,"Howard County, IA",Howard County, IA,2011,5320,5036,284,5.3
19,91,"Humboldt County, IA",Humboldt County, IA,2011,5170,4910,260,5
19,93,"Ida County, IA",Ida County, IA,2011,3793,3609,184,4.9
19,95,"Iowa County, IA",Iowa County, IA,2011,9609,9128,481,5
19,97,"Jackson County, IA",Jackson County, IA,2011,10991,10277,714,6.5
19,99,"Jasper County, IA",Jasper County, IA,2011,18605,17359,1246,6.7
19,101,"Jefferson County, IA",Jefferson County, IA,2011,8816,8288,528,6
19,103,"Johnson County, IA",Johnson County, IA,2011,79671,76457,3214,4
19,105,"Jones County, IA",Jones County, IA,2011,10915,10281,634,5.8
19,107,"Keokuk County, IA",Keokuk County, IA,2011,5472,5137,335,6.1
19,109,"Kossuth County, IA",Kossuth County, IA,2011,8354,7990,364,4.4
19,111,"Lee County, IA",Lee County, IA,2011,17440,16020,1420,8.1
19,113,"Linn County, IA",Linn County, IA,2011,119379,112600,6779,5.7
19,115,"Louisa County, IA",Louisa County, IA,2011,5905,5545,360,6.1
19,117,"Lucas County, IA",Lucas County, IA,2011,4185,3964,221,5.3
19,119,"Lyon County, IA",Lyon County, IA,2011,6774,6563,211,3.1
19,121,"Madison County, IA",Madison County, IA,2011,8274,7781,493,6
19,123,"Mahaska County, IA",Mahaska County, IA,2011,11834,11144,690,5.8
19,125,"Marion County, IA",Marion County, IA,2011,17163,16229,934,5.4
19,127,"Marshall County, IA",Marshall County, IA,2011,20047,18729,1318,6.6
19,129,"Mills County, IA",Mills County, IA,2011,7447,7079,368,4.9
19,131,"Mitchell County, IA",Mitchell County, IA,2011,5652,5384,268,4.7
19,133,"Monona County, IA",Monona County, IA,2011,4774,4443,331,6.9
19,135,"Monroe County, IA",Monroe County, IA,2011,4034,3763,271,6.7
19,137,"Montgomery County, IA",Montgomery County, IA,2011,5034,4739,295,5.9
19,139,"Muscatine County, IA",Muscatine County, IA,2011,21410,20002,1408,6.6
19,141,"O'Brien County, IA",O'Brien County, IA,2011,8104,7765,339,4.2
19,143,"Osceola County, IA",Osceola County, IA,2011,3527,3370,157,4.5
19,145,"Page County, IA",Page County, IA,2011,6856,6465,391,5.7
19,147,"Palo Alto County, IA",Palo Alto County, IA,2011,4774,4550,224,4.7
19,149,"Plymouth County, IA",Plymouth County, IA,2011,14248,13613,635,4.5
19,151,"Pocahontas County, IA",Pocahontas County, IA,2011,4081,3902,179,4.4
19,153,"Polk County, IA",Polk County, IA,2011,242974,229207,13767,5.7
19,155,"Pottawattamie County, IA",Pottawattamie County, IA,2011,49538,46770,2768,5.6
19,157,"Poweshiek County, IA",Poweshiek County, IA,2011,10396,9817,579,5.6
19,159,"Ringgold County, IA",Ringgold County, IA,2011,2600,2481,119,4.6
19,161,"Sac County, IA",Sac County, IA,2011,5617,5369,248,4.4
19,163,"Scott County, IA",Scott County, IA,2011,86747,81405,5342,6.2
19,165,"Shelby County, IA",Shelby County, IA,2011,6717,6427,290,4.3
19,167,"Sioux County, IA",Sioux County, IA,2011,19529,18810,719,3.7
19,169,"Story County, IA",Story County, IA,2011,53207,51111,2096,3.9
19,171,"Tama County, IA",Tama County, IA,2011,9190,8629,561,6.1
19,173,"Taylor County, IA",Taylor County, IA,2011,3151,3002,149,4.7
19,175,"Union County, IA",Union County, IA,2011,6958,6592,366,5.3
19,177,"Van Buren County, IA",Van Buren County, IA,2011,3849,3606,243,6.3
19,179,"Wapello County, IA",Wapello County, IA,2011,18118,16822,1296,7.2
19,181,"Warren County, IA",Warren County, IA,2011,25952,24607,1345,5.2
19,183,"Washington County, IA",Washington County, IA,2011,12313,11736,577,4.7
19,185,"Wayne County, IA",Wayne County, IA,2011,2823,2667,156,5.5
19,187,"Webster County, IA",Webster County, IA,2011,19774,18396,1378,7
19,189,"Winnebago County, IA",Winnebago County, IA,2011,5445,5117,328,6
19,191,"Winneshiek County, IA",Winneshiek County, IA,2011,12112,11509,603,5
19,193,"Woodbury County, IA",Woodbury County, IA,2011,54559,51431,3128,5.7
19,195,"Worth County, IA",Worth County, IA,2011,4288,4014,274,6.4
19,197,"Wright County, IA",Wright County, IA,2011,6787,6322,465,6.9
20,1,"Allen County, KS",Allen County, KS,2011,7032,6468,564,8
20,3,"Anderson County, KS",Anderson County, KS,2011,4490,4148,342,7.6
20,5,"Atchison County, KS",Atchison County, KS,2011,7926,7209,717,9
20,7,"Barber County, KS",Barber County, KS,2011,2778,2667,111,4
20,9,"Barton County, KS",Barton County, KS,2011,15036,14252,784,5.2
20,11,"Bourbon County, KS",Bourbon County, KS,2011,6876,6259,617,9
20,13,"Brown County, KS",Brown County, KS,2011,5186,4877,309,6
20,15,"Butler County, KS",Butler County, KS,2011,32445,30171,2274,7
20,17,"Chase County, KS",Chase County, KS,2011,1338,1265,73,5.5
20,19,"Chautauqua County, KS",Chautauqua County, KS,2011,1699,1559,140,8.2
20,21,"Cherokee County, KS",Cherokee County, KS,2011,10801,9924,877,8.1
20,23,"Cheyenne County, KS",Cheyenne County, KS,2011,1346,1288,58,4.3
20,25,"Clark County, KS",Clark County, KS,2011,1211,1165,46,3.8
20,27,"Clay County, KS",Clay County, KS,2011,4389,4141,248,5.7
20,29,"Cloud County, KS",Cloud County, KS,2011,4527,4279,248,5.5
20,31,"Coffey County, KS",Coffey County, KS,2011,4649,4285,364,7.8
20,33,"Comanche County, KS",Comanche County, KS,2011,980,937,43,4.4
20,35,"Cowley County, KS",Cowley County, KS,2011,17096,15896,1200,7
20,37,"Crawford County, KS",Crawford County, KS,2011,19169,17652,1517,7.9
20,39,"Decatur County, KS",Decatur County, KS,2011,1415,1347,68,4.8
20,41,"Dickinson County, KS",Dickinson County, KS,2011,10109,9442,667,6.6
20,43,"Doniphan County, KS",Doniphan County, KS,2011,4453,4105,348,7.8
20,45,"Douglas County, KS",Douglas County, KS,2011,63747,60141,3606,5.7
20,47,"Edwards County, KS",Edwards County, KS,2011,1664,1589,75,4.5
20,49,"Elk County, KS",Elk County, KS,2011,1382,1277,105,7.6
20,51,"Ellis County, KS",Ellis County, KS,2011,17841,17209,632,3.5
20,53,"Ellsworth County, KS",Ellsworth County, KS,2011,3491,3349,142,4.1
20,55,"Finney County, KS",Finney County, KS,2011,20743,19857,886,4.3
20,57,"Ford County, KS",Ford County, KS,2011,18271,17483,788,4.3
20,59,"Franklin County, KS",Franklin County, KS,2011,13989,12817,1172,8.4
20,61,"Geary County, KS",Geary County, KS,2011,13174,11964,1210,9.2
20,63,"Gove County, KS",Gove County, KS,2011,1498,1448,50,3.3
20,65,"Graham County, KS",Graham County, KS,2011,1416,1357,59,4.2
20,67,"Grant County, KS",Grant County, KS,2011,4104,3932,172,4.2
20,69,"Gray County, KS",Gray County, KS,2011,3585,3466,119,3.3
20,71,"Greeley County, KS",Greeley County, KS,2011,842,816,26,3.1
20,73,"Greenwood County, KS",Greenwood County, KS,2011,3466,3236,230,6.6
20,75,"Hamilton County, KS",Hamilton County, KS,2011,1746,1697,49,2.8
20,77,"Harper County, KS",Harper County, KS,2011,2895,2731,164,5.7
20,79,"Harvey County, KS",Harvey County, KS,2011,17387,16330,1057,6.1
20,81,"Haskell County, KS",Haskell County, KS,2011,2414,2329,85,3.5
20,83,"Hodgeman County, KS",Hodgeman County, KS,2011,1109,1067,42,3.8
20,85,"Jackson County, KS",Jackson County, KS,2011,7419,6973,446,6
20,87,"Jefferson County, KS",Jefferson County, KS,2011,10450,9707,743,7.1
20,89,"Jewell County, KS",Jewell County, KS,2011,1528,1456,72,4.7
20,91,"Johnson County, KS",Johnson County, KS,2011,308303,291774,16529,5.4
20,93,"Kearny County, KS",Kearny County, KS,2011,2179,2083,96,4.4
20,95,"Kingman County, KS",Kingman County, KS,2011,3823,3579,244,6.4
20,97,"Kiowa County, KS",Kiowa County, KS,2011,1344,1287,57,4.2
20,99,"Labette County, KS",Labette County, KS,2011,11038,10039,999,9.1
20,101,"Lane County, KS",Lane County, KS,2011,959,915,44,4.6
20,103,"Leavenworth County, KS",Leavenworth County, KS,2011,34425,31917,2508,7.3
20,105,"Lincoln County, KS",Lincoln County, KS,2011,1877,1780,97,5.2
20,107,"Linn County, KS",Linn County, KS,2011,4501,3999,502,11.2
20,109,"Logan County, KS",Logan County, KS,2011,1774,1716,58,3.3
20,111,"Lyon County, KS",Lyon County, KS,2011,17333,16222,1111,6.4
20,113,"McPherson County, KS",McPherson County, KS,2011,16652,15892,760,4.6
20,115,"Marion County, KS",Marion County, KS,2011,6471,6104,367,5.7
20,117,"Marshall County, KS",Marshall County, KS,2011,5992,5713,279,4.7
20,119,"Meade County, KS",Meade County, KS,2011,2534,2440,94,3.7
20,121,"Miami County, KS",Miami County, KS,2011,16914,15696,1218,7.2
20,123,"Mitchell County, KS",Mitchell County, KS,2011,3893,3753,140,3.6
20,125,"Montgomery County, KS",Montgomery County, KS,2011,18272,16458,1814,9.9
20,127,"Morris County, KS",Morris County, KS,2011,3289,3069,220,6.7
20,129,"Morton County, KS",Morton County, KS,2011,1674,1612,62,3.7
20,131,"Nemaha County, KS",Nemaha County, KS,2011,5900,5672,228,3.9
20,133,"Neosho County, KS",Neosho County, KS,2011,7400,6713,687,9.3
20,135,"Ness County, KS",Ness County, KS,2011,1623,1568,55,3.4
20,137,"Norton County, KS",Norton County, KS,2011,3138,3028,110,3.5
20,139,"Osage County, KS",Osage County, KS,2011,8568,7857,711,8.3
20,141,"Osborne County, KS",Osborne County, KS,2011,2261,2160,101,4.5
20,143,"Ottawa County, KS",Ottawa County, KS,2011,3270,3082,188,5.7
20,145,"Pawnee County, KS",Pawnee County, KS,2011,3481,3322,159,4.6
20,147,"Phillips County, KS",Phillips County, KS,2011,3019,2866,153,5.1
20,149,"Pottawatomie County, KS",Pottawatomie County, KS,2011,11564,10986,578,5
20,151,"Pratt County, KS",Pratt County, KS,2011,5362,5091,271,5.1
20,153,"Rawlins County, KS",Rawlins County, KS,2011,1518,1465,53,3.5
20,155,"Reno County, KS",Reno County, KS,2011,32636,30664,1972,6
20,157,"Republic County, KS",Republic County, KS,2011,2683,2580,103,3.8
20,159,"Rice County, KS",Rice County, KS,2011,5388,5109,279,5.2
20,161,"Riley County, KS",Riley County, KS,2011,35427,33724,1703,4.8
20,163,"Rooks County, KS",Rooks County, KS,2011,2726,2581,145,5.3
20,165,"Rush County, KS",Rush County, KS,2011,1841,1760,81,4.4
20,167,"Russell County, KS",Russell County, KS,2011,3784,3607,177,4.7
20,169,"Saline County, KS",Saline County, KS,2011,30761,28891,1870,6.1
20,171,"Scott County, KS",Scott County, KS,2011,2725,2623,102,3.7
20,173,"Sedgwick County, KS",Sedgwick County, KS,2011,249217,229352,19865,8
20,175,"Seward County, KS",Seward County, KS,2011,10820,10321,499,4.6
20,177,"Shawnee County, KS",Shawnee County, KS,2011,92932,86630,6302,6.8
20,179,"Sheridan County, KS",Sheridan County, KS,2011,1526,1477,49,3.2
20,181,"Sherman County, KS",Sherman County, KS,2011,3205,3076,129,4
20,183,"Smith County, KS",Smith County, KS,2011,2265,2174,91,4
20,185,"Stafford County, KS",Stafford County, KS,2011,2317,2198,119,5.1
20,187,"Stanton County, KS",Stanton County, KS,2011,1064,1021,43,4
20,189,"Stevens County, KS",Stevens County, KS,2011,2765,2653,112,4.1
20,191,"Sumner County, KS",Sumner County, KS,2011,11573,10687,886,7.7
20,193,"Thomas County, KS",Thomas County, KS,2011,4600,4431,169,3.7
20,195,"Trego County, KS",Trego County, KS,2011,1494,1424,70,4.7
20,197,"Wabaunsee County, KS",Wabaunsee County, KS,2011,3837,3597,240,6.3
20,199,"Wallace County, KS",Wallace County, KS,2011,882,834,48,5.4
20,201,"Washington County, KS",Washington County, KS,2011,3309,3158,151,4.6
20,203,"Wichita County, KS",Wichita County, KS,2011,1329,1278,51,3.8
20,205,"Wilson County, KS",Wilson County, KS,2011,4270,3782,488,11.4
20,207,"Woodson County, KS",Woodson County, KS,2011,1718,1602,116,6.8
20,209,"Wyandotte County, KS",Wyandotte County, KS,2011,74544,67430,7114,9.5
21,1,"Adair County, KY",Adair County, KY,2011,7747,6834,913,11.8
21,3,"Allen County, KY",Allen County, KY,2011,9111,8215,896,9.8
21,5,"Anderson County, KY",Anderson County, KY,2011,11567,10603,964,8.3
21,7,"Ballard County, KY",Ballard County, KY,2011,3884,3497,387,10
21,9,"Barren County, KY",Barren County, KY,2011,19890,17940,1950,9.8
21,11,"Bath County, KY",Bath County, KY,2011,4835,4224,611,12.6
21,13,"Bell County, KY",Bell County, KY,2011,10190,8976,1214,11.9
21,15,"Boone County, KY",Boone County, KY,2011,64221,59178,5043,7.9
21,17,"Bourbon County, KY",Bourbon County, KY,2011,10046,9198,848,8.4
21,19,"Boyd County, KY",Boyd County, KY,2011,20244,18162,2082,10.3
21,21,"Boyle County, KY",Boyle County, KY,2011,13157,11743,1414,10.7
21,23,"Bracken County, KY",Bracken County, KY,2011,3981,3553,428,10.8
21,25,"Breathitt County, KY",Breathitt County, KY,2011,4410,3847,563,12.8
21,27,"Breckinridge County, KY",Breckinridge County, KY,2011,8280,7323,957,11.6
21,29,"Bullitt County, KY",Bullitt County, KY,2011,38954,35079,3875,9.9
21,31,"Butler County, KY",Butler County, KY,2011,5452,4867,585,10.7
21,33,"Caldwell County, KY",Caldwell County, KY,2011,5695,5149,546,9.6
21,35,"Calloway County, KY",Calloway County, KY,2011,19019,17593,1426,7.5
21,37,"Campbell County, KY",Campbell County, KY,2011,48811,44758,4053,8.3
21,39,"Carlisle County, KY",Carlisle County, KY,2011,2305,2101,204,8.9
21,41,"Carroll County, KY",Carroll County, KY,2011,5110,4487,623,12.2
21,43,"Carter County, KY",Carter County, KY,2011,11696,10079,1617,13.8
21,45,"Casey County, KY",Casey County, KY,2011,6980,6283,697,10
21,47,"Christian County, KY",Christian County, KY,2011,26810,23916,2894,10.8
21,49,"Clark County, KY",Clark County, KY,2011,17537,15804,1733,9.9
21,51,"Clay County, KY",Clay County, KY,2011,6052,5142,910,15
21,53,"Clinton County, KY",Clinton County, KY,2011,4281,3794,487,11.4
21,55,"Crittenden County, KY",Crittenden County, KY,2011,4174,3819,355,8.5
21,57,"Cumberland County, KY",Cumberland County, KY,2011,3118,2775,343,11
21,59,"Daviess County, KY",Daviess County, KY,2011,47742,43754,3988,8.4
21,61,"Edmonson County, KY",Edmonson County, KY,2011,5122,4523,599,11.7
21,63,"Elliott County, KY",Elliott County, KY,2011,2331,1963,368,15.8
21,65,"Estill County, KY",Estill County, KY,2011,5607,4910,697,12.4
21,67,"Fayette County, KY",Fayette County, KY,2011,164926,153602,11324,6.9
21,69,"Fleming County, KY",Fleming County, KY,2011,6466,5779,687,10.6
21,71,"Floyd County, KY",Floyd County, KY,2011,13716,12183,1533,11.2
21,73,"Franklin County, KY",Franklin County, KY,2011,24611,22664,1947,7.9
21,75,"Fulton County, KY",Fulton County, KY,2011,2659,2327,332,12.5
21,77,"Gallatin County, KY",Gallatin County, KY,2011,4004,3574,430,10.7
21,79,"Garrard County, KY",Garrard County, KY,2011,7810,7026,784,10
21,81,"Grant County, KY",Grant County, KY,2011,11623,10385,1238,10.7
21,83,"Graves County, KY",Graves County, KY,2011,16903,15367,1536,9.1
21,85,"Grayson County, KY",Grayson County, KY,2011,11397,9999,1398,12.3
21,87,"Green County, KY",Green County, KY,2011,5452,4925,527,9.7
21,89,"Greenup County, KY",Greenup County, KY,2011,15208,13502,1706,11.2
21,91,"Hancock County, KY",Hancock County, KY,2011,4080,3738,342,8.4
21,93,"Hardin County, KY",Hardin County, KY,2011,47443,43077,4366,9.2
21,95,"Harlan County, KY",Harlan County, KY,2011,10025,8904,1121,11.2
21,97,"Harrison County, KY",Harrison County, KY,2011,8950,8050,900,10.1
21,99,"Hart County, KY",Hart County, KY,2011,8196,7387,809,9.9
21,101,"Henderson County, KY",Henderson County, KY,2011,22865,20810,2055,9
21,103,"Henry County, KY",Henry County, KY,2011,7752,7070,682,8.8
21,105,"Hickman County, KY",Hickman County, KY,2011,2282,2078,204,8.9
21,107,"Hopkins County, KY",Hopkins County, KY,2011,21545,19720,1825,8.5
21,109,"Jackson County, KY",Jackson County, KY,2011,5294,4576,718,13.6
21,111,"Jefferson County, KY",Jefferson County, KY,2011,378781,342935,35846,9.5
21,113,"Jessamine County, KY",Jessamine County, KY,2011,24650,22732,1918,7.8
21,115,"Johnson County, KY",Johnson County, KY,2011,8691,7747,944,10.9
21,117,"Kenton County, KY",Kenton County, KY,2011,83780,76372,7408,8.8
21,119,"Knott County, KY",Knott County, KY,2011,5849,5157,692,11.8
21,121,"Knox County, KY",Knox County, KY,2011,10634,9220,1414,13.3
21,123,"Larue County, KY",Larue County, KY,2011,6046,5441,605,10
21,125,"Laurel County, KY",Laurel County, KY,2011,24978,22114,2864,11.5
21,127,"Lawrence County, KY",Lawrence County, KY,2011,5774,5097,677,11.7
21,129,"Lee County, KY",Lee County, KY,2011,2512,2195,317,12.6
21,131,"Leslie County, KY",Leslie County, KY,2011,3632,3173,459,12.6
21,133,"Letcher County, KY",Letcher County, KY,2011,8883,7974,909,10.2
21,135,"Lewis County, KY",Lewis County, KY,2011,5517,4799,718,13
21,137,"Lincoln County, KY",Lincoln County, KY,2011,10405,9129,1276,12.3
21,139,"Livingston County, KY",Livingston County, KY,2011,4024,3583,441,11
21,141,"Logan County, KY",Logan County, KY,2011,12440,11327,1113,8.9
21,143,"Lyon County, KY",Lyon County, KY,2011,3078,2759,319,10.4
21,145,"McCracken County, KY",McCracken County, KY,2011,30974,28299,2675,8.6
21,147,"McCreary County, KY",McCreary County, KY,2011,5690,4858,832,14.6
21,149,"McLean County, KY",McLean County, KY,2011,4564,4159,405,8.9
21,151,"Madison County, KY",Madison County, KY,2011,44056,40587,3469,7.9
21,153,"Magoffin County, KY",Magoffin County, KY,2011,4150,3439,711,17.1
21,155,"Marion County, KY",Marion County, KY,2011,9200,8203,997,10.8
21,157,"Marshall County, KY",Marshall County, KY,2011,15441,14012,1429,9.3
21,159,"Martin County, KY",Martin County, KY,2011,3870,3522,348,9
21,161,"Mason County, KY",Mason County, KY,2011,7660,6871,789,10.3
21,163,"Meade County, KY",Meade County, KY,2011,12815,11370,1445,11.3
21,165,"Menifee County, KY",Menifee County, KY,2011,2543,2185,358,14.1
21,167,"Mercer County, KY",Mercer County, KY,2011,10234,9173,1061,10.4
21,169,"Metcalfe County, KY",Metcalfe County, KY,2011,4611,4093,518,11.2
21,171,"Monroe County, KY",Monroe County, KY,2011,4834,4398,436,9
21,173,"Montgomery County, KY",Montgomery County, KY,2011,12080,10727,1353,11.2
21,175,"Morgan County, KY",Morgan County, KY,2011,5232,4656,576,11
21,177,"Muhlenberg County, KY",Muhlenberg County, KY,2011,12942,11614,1328,10.3
21,179,"Nelson County, KY",Nelson County, KY,2011,21806,19488,2318,10.6
21,181,"Nicholas County, KY",Nicholas County, KY,2011,3585,3260,325,9.1
21,183,"Ohio County, KY",Ohio County, KY,2011,10352,9332,1020,9.9
21,185,"Oldham County, KY",Oldham County, KY,2011,29260,27225,2035,7
21,187,"Owen County, KY",Owen County, KY,2011,5701,5266,435,7.6
21,189,"Owsley County, KY",Owsley County, KY,2011,1389,1206,183,13.2
21,191,"Pendleton County, KY",Pendleton County, KY,2011,7201,6421,780,10.8
21,193,"Perry County, KY",Perry County, KY,2011,11020,9875,1145,10.4
21,195,"Pike County, KY",Pike County, KY,2011,24323,22094,2229,9.2
21,197,"Powell County, KY",Powell County, KY,2011,5153,4487,666,12.9
21,199,"Pulaski County, KY",Pulaski County, KY,2011,27525,24591,2934,10.7
21,201,"Robertson County, KY",Robertson County, KY,2011,859,763,96,11.2
21,203,"Rockcastle County, KY",Rockcastle County, KY,2011,7193,6369,824,11.5
21,205,"Rowan County, KY",Rowan County, KY,2011,11237,10168,1069,9.5
21,207,"Russell County, KY",Russell County, KY,2011,7350,6488,862,11.7
21,209,"Scott County, KY",Scott County, KY,2011,25543,23511,2032,8
21,211,"Shelby County, KY",Shelby County, KY,2011,21968,20222,1746,7.9
21,213,"Simpson County, KY",Simpson County, KY,2011,8612,7662,950,11
21,215,"Spencer County, KY",Spencer County, KY,2011,9248,8411,837,9.1
21,217,"Taylor County, KY",Taylor County, KY,2011,11925,10634,1291,10.8
21,219,"Todd County, KY",Todd County, KY,2011,5708,5210,498,8.7
21,221,"Trigg County, KY",Trigg County, KY,2011,6190,5487,703,11.4
21,223,"Trimble County, KY",Trimble County, KY,2011,4016,3559,457,11.4
21,225,"Union County, KY",Union County, KY,2011,7598,6914,684,9
21,227,"Warren County, KY",Warren County, KY,2011,58969,54095,4874,8.3
21,229,"Washington County, KY",Washington County, KY,2011,6125,5557,568,9.3
21,231,"Wayne County, KY",Wayne County, KY,2011,7888,6763,1125,14.3
21,233,"Webster County, KY",Webster County, KY,2011,6212,5713,499,8
21,235,"Whitley County, KY",Whitley County, KY,2011,13901,12228,1673,12
21,237,"Wolfe County, KY",Wolfe County, KY,2011,2104,1791,313,14.9
21,239,"Woodford County, KY",Woodford County, KY,2011,14326,13393,933,6.5
22,1,"Acadia Parish, LA",Acadia Parish, LA,2011,25791,24068,1723,6.7
22,3,"Allen Parish, LA",Allen Parish, LA,2011,9214,8375,839,9.1
22,5,"Ascension Parish, LA",Ascension Parish, LA,2011,53941,50141,3800,7
22,7,"Assumption Parish, LA",Assumption Parish, LA,2011,9974,8770,1204,12.1
22,9,"Avoyelles Parish, LA",Avoyelles Parish, LA,2011,16638,15240,1398,8.4
22,11,"Beauregard Parish, LA",Beauregard Parish, LA,2011,14269,13098,1171,8.2
22,13,"Bienville Parish, LA",Bienville Parish, LA,2011,5860,5266,594,10.1
22,15,"Bossier Parish, LA",Bossier Parish, LA,2011,56901,53561,3340,5.9
22,17,"Caddo Parish, LA",Caddo Parish, LA,2011,115609,106425,9184,7.9
22,19,"Calcasieu Parish, LA",Calcasieu Parish, LA,2011,87010,80317,6693,7.7
22,21,"Caldwell Parish, LA",Caldwell Parish, LA,2011,4103,3693,410,10
22,23,"Cameron Parish, LA",Cameron Parish, LA,2011,3250,3063,187,5.8
22,25,"Catahoula Parish, LA",Catahoula Parish, LA,2011,4060,3641,419,10.3
22,27,"Claiborne Parish, LA",Claiborne Parish, LA,2011,6866,6295,571,8.3
22,29,"Concordia Parish, LA",Concordia Parish, LA,2011,7813,7063,750,9.6
22,31,"De Soto Parish, LA",De Soto Parish, LA,2011,11228,10278,950,8.5
22,33,"East Baton Rouge Parish, LA",East Baton Rouge Parish, LA,2011,221086,204338,16748,7.6
22,35,"East Carroll Parish, LA",East Carroll Parish, LA,2011,2342,1918,424,18.1
22,37,"East Feliciana Parish, LA",East Feliciana Parish, LA,2011,8049,7366,683,8.5
22,39,"Evangeline Parish, LA",Evangeline Parish, LA,2011,13026,11930,1096,8.4
22,41,"Franklin Parish, LA",Franklin Parish, LA,2011,7961,7032,929,11.7
22,43,"Grant Parish, LA",Grant Parish, LA,2011,8358,7655,703,8.4
22,45,"Iberia Parish, LA",Iberia Parish, LA,2011,31877,29358,2519,7.9
22,47,"Iberville Parish, LA",Iberville Parish, LA,2011,13976,12529,1447,10.4
22,49,"Jackson Parish, LA",Jackson Parish, LA,2011,6945,6431,514,7.4
22,51,"Jefferson Parish, LA",Jefferson Parish, LA,2011,213027,197665,15362,7.2
22,53,"Jefferson Davis Parish, LA",Jefferson Davis Parish, LA,2011,12907,11976,931,7.2
22,55,"Lafayette Parish, LA",Lafayette Parish, LA,2011,113869,107117,6752,5.9
22,57,"Lafourche Parish, LA",Lafourche Parish, LA,2011,44381,41664,2717,6.1
22,59,"LaSalle Parish, LA",LaSalle Parish, LA,2011,6689,6306,383,5.7
22,61,"Lincoln Parish, LA",Lincoln Parish, LA,2011,20086,18229,1857,9.2
22,63,"Livingston Parish, LA",Livingston Parish, LA,2011,61455,56967,4488,7.3
22,65,"Madison Parish, LA",Madison Parish, LA,2011,3980,3476,504,12.7
22,67,"Morehouse Parish, LA",Morehouse Parish, LA,2011,11062,9466,1596,14.4
22,69,"Natchitoches Parish, LA",Natchitoches Parish, LA,2011,16143,14652,1491,9.2
22,71,"Orleans Parish, LA",Orleans Parish, LA,2011,165726,151413,14313,8.6
22,73,"Ouachita Parish, LA",Ouachita Parish, LA,2011,69852,64029,5823,8.3
22,75,"Plaquemines Parish, LA",Plaquemines Parish, LA,2011,10086,9448,638,6.3
22,77,"Pointe Coupee Parish, LA",Pointe Coupee Parish, LA,2011,9980,9068,912,9.1
22,79,"Rapides Parish, LA",Rapides Parish, LA,2011,58206,53753,4453,7.7
22,81,"Red River Parish, LA",Red River Parish, LA,2011,4049,3737,312,7.7
22,83,"Richland Parish, LA",Richland Parish, LA,2011,8796,7839,957,10.9
22,85,"Sabine Parish, LA",Sabine Parish, LA,2011,9460,8785,675,7.1
22,87,"St. Bernard Parish, LA",St. Bernard Parish, LA,2011,16856,15424,1432,8.5
22,89,"St. Charles Parish, LA",St. Charles Parish, LA,2011,24836,23044,1792,7.2
22,91,"St. Helena Parish, LA",St. Helena Parish, LA,2011,4637,4002,635,13.7
22,93,"St. James Parish, LA",St. James Parish, LA,2011,9943,8738,1205,12.1
22,95,"St. John the Baptist Parish, LA",St. John the Baptist Parish, LA,2011,20953,18736,2217,10.6
22,97,"St. Landry Parish, LA",St. Landry Parish, LA,2011,33637,30471,3166,9.4
22,99,"St. Martin Parish, LA",St. Martin Parish, LA,2011,24085,22309,1776,7.4
22,101,"St. Mary Parish, LA",St. Mary Parish, LA,2011,25136,22898,2238,8.9
22,103,"St. Tammany Parish, LA",St. Tammany Parish, LA,2011,107963,101175,6788,6.3
22,105,"Tangipahoa Parish, LA",Tangipahoa Parish, LA,2011,53286,48168,5118,9.6
22,107,"Tensas Parish, LA",Tensas Parish, LA,2011,1979,1723,256,12.9
22,109,"Terrebonne Parish, LA",Terrebonne Parish, LA,2011,49902,46798,3104,6.2
22,111,"Union Parish, LA",Union Parish, LA,2011,9345,8464,881,9.4
22,113,"Vermilion Parish, LA",Vermilion Parish, LA,2011,25357,23684,1673,6.6
22,115,"Vernon Parish, LA",Vernon Parish, LA,2011,19235,17501,1734,9
22,117,"Washington Parish, LA",Washington Parish, LA,2011,16615,15039,1576,9.5
22,119,"Webster Parish, LA",Webster Parish, LA,2011,16569,14900,1669,10.1
22,121,"West Baton Rouge Parish, LA",West Baton Rouge Parish, LA,2011,11927,10999,928,7.8
22,123,"West Carroll Parish, LA",West Carroll Parish, LA,2011,4268,3590,678,15.9
22,125,"West Feliciana Parish, LA",West Feliciana Parish, LA,2011,5138,4799,339,6.6
22,127,"Winn Parish, LA",Winn Parish, LA,2011,5651,5119,532,9.4
23,1,"Androscoggin County, ME",Androscoggin County, ME,2011,56063,51505,4558,8.1
23,3,"Aroostook County, ME",Aroostook County, ME,2011,34541,31148,3393,9.8
23,5,"Cumberland County, ME",Cumberland County, ME,2011,158049,148085,9964,6.3
23,7,"Franklin County, ME",Franklin County, ME,2011,15522,14124,1398,9
23,9,"Hancock County, ME",Hancock County, ME,2011,30106,27412,2694,8.9
23,11,"Kennebec County, ME",Kennebec County, ME,2011,63248,58542,4706,7.4
23,13,"Knox County, ME",Knox County, ME,2011,20437,18934,1503,7.4
23,15,"Lincoln County, ME",Lincoln County, ME,2011,17137,15796,1341,7.8
23,17,"Oxford County, ME",Oxford County, ME,2011,27893,24953,2940,10.5
23,19,"Penobscot County, ME",Penobscot County, ME,2011,79628,72973,6655,8.4
23,21,"Piscataquis County, ME",Piscataquis County, ME,2011,7911,7139,772,9.8
23,23,"Sagadahoc County, ME",Sagadahoc County, ME,2011,19128,17852,1276,6.7
23,25,"Somerset County, ME",Somerset County, ME,2011,24664,21998,2666,10.8
23,27,"Waldo County, ME",Waldo County, ME,2011,20364,18697,1667,8.2
23,29,"Washington County, ME",Washington County, ME,2011,14909,13335,1574,10.6
23,31,"York County, ME",York County, ME,2011,109666,101586,8080,7.4
24,1,"Allegany County, MD",Allegany County, MD,2011,34087,31001,3086,9.1
24,3,"Anne Arundel County, MD",Anne Arundel County, MD,2011,289334,271043,18291,6.3
24,5,"Baltimore County, MD",Baltimore County, MD,2011,435544,402056,33488,7.7
24,9,"Calvert County, MD",Calvert County, MD,2011,47713,44612,3101,6.5
24,11,"Caroline County, MD",Caroline County, MD,2011,17482,15973,1509,8.6
24,13,"Carroll County, MD",Carroll County, MD,2011,92837,87140,5697,6.1
24,15,"Cecil County, MD",Cecil County, MD,2011,52098,47471,4627,8.9
24,17,"Charles County, MD",Charles County, MD,2011,78996,73697,5299,6.7
24,19,"Dorchester County, MD",Dorchester County, MD,2011,16525,14688,1837,11.1
24,21,"Frederick County, MD",Frederick County, MD,2011,128566,120294,8272,6.4
24,23,"Garrett County, MD",Garrett County, MD,2011,15810,14483,1327,8.4
24,25,"Harford County, MD",Harford County, MD,2011,133823,124168,9655,7.2
24,27,"Howard County, MD",Howard County, MD,2011,163945,155433,8512,5.2
24,29,"Kent County, MD",Kent County, MD,2011,10768,9900,868,8.1
24,31,"Montgomery County, MD",Montgomery County, MD,2011,536832,508549,28283,5.3
24,33,"Prince George's County, MD",Prince George's County, MD,2011,482913,446857,36056,7.5
24,35,"Queen Anne's County, MD",Queen Anne's County, MD,2011,26608,24800,1808,6.8
24,37,"St. Mary's County, MD",St. Mary's County, MD,2011,54265,50842,3423,6.3
24,39,"Somerset County, MD",Somerset County, MD,2011,9890,8735,1155,11.7
24,41,"Talbot County, MD",Talbot County, MD,2011,19450,18001,1449,7.4
24,43,"Washington County, MD",Washington County, MD,2011,76481,69771,6710,8.8
24,45,"Wicomico County, MD",Wicomico County, MD,2011,50630,45665,4965,9.8
24,47,"Worcester County, MD",Worcester County, MD,2011,26385,22769,3616,13.7
24,510,"Baltimore city, MD",Baltimore city, MD,2011,295579,264134,31445,10.6
25,1,"Barnstable County, MA",Barnstable County, MA,2011,109578,99669,9909,9
25,3,"Berkshire County, MA",Berkshire County, MA,2011,67282,62011,5271,7.8
25,5,"Bristol County, MA",Bristol County, MA,2011,284512,257954,26558,9.3
25,7,"Dukes County, MA",Dukes County, MA,2011,9141,8287,854,9.3
25,9,"Essex County, MA",Essex County, MA,2011,392693,362791,29902,7.6
25,11,"Franklin County, MA",Franklin County, MA,2011,39535,37004,2531,6.4
25,13,"Hampden County, MA",Hampden County, MA,2011,219044,198246,20798,9.5
25,15,"Hampshire County, MA",Hampshire County, MA,2011,84733,79717,5016,5.9
25,17,"Middlesex County, MA",Middlesex County, MA,2011,824097,775794,48303,5.9
25,19,"Nantucket County/town, MA",Nantucket County/town, MA,2011,6204,5670,534,8.6
25,21,"Norfolk County, MA",Norfolk County, MA,2011,357322,334751,22571,6.3
25,23,"Plymouth County, MA",Plymouth County, MA,2011,261073,240731,20342,7.8
25,25,"Suffolk County, MA",Suffolk County, MA,2011,396013,369558,26455,6.7
25,27,"Worcester County, MA",Worcester County, MA,2011,418082,385571,32511,7.8
26,1,"Alcona County, MI",Alcona County, MI,2011,3807,3261,546,14.3
26,3,"Alger County, MI",Alger County, MI,2011,3475,3035,440,12.7
26,5,"Allegan County, MI",Allegan County, MI,2011,56816,51848,4968,8.7
26,7,"Alpena County, MI",Alpena County, MI,2011,13684,12200,1484,10.8
26,9,"Antrim County, MI",Antrim County, MI,2011,10165,8817,1348,13.3
26,11,"Arenac County, MI",Arenac County, MI,2011,6688,5747,941,14.1
26,13,"Baraga County, MI",Baraga County, MI,2011,3661,3060,601,16.4
26,15,"Barry County, MI",Barry County, MI,2011,28877,26517,2360,8.2
26,17,"Bay County, MI",Bay County, MI,2011,53317,48064,5253,9.9
26,19,"Benzie County, MI",Benzie County, MI,2011,8693,7646,1047,12
26,21,"Berrien County, MI",Berrien County, MI,2011,74551,66972,7579,10.2
26,23,"Branch County, MI",Branch County, MI,2011,19173,17165,2008,10.5
26,25,"Calhoun County, MI",Calhoun County, MI,2011,63216,57020,6196,9.8
26,27,"Cass County, MI",Cass County, MI,2011,24419,22057,2362,9.7
26,29,"Charlevoix County, MI",Charlevoix County, MI,2011,12925,11352,1573,12.2
26,31,"Cheboygan County, MI",Cheboygan County, MI,2011,10839,9507,1332,12.3
26,33,"Chippewa County, MI",Chippewa County, MI,2011,17390,15503,1887,10.9
26,35,"Clare County, MI",Clare County, MI,2011,12169,10563,1606,13.2
26,37,"Clinton County, MI",Clinton County, MI,2011,38944,36232,2712,7
26,39,"Crawford County, MI",Crawford County, MI,2011,5498,4793,705,12.8
26,41,"Delta County, MI",Delta County, MI,2011,17814,15897,1917,10.8
26,43,"Dickinson County, MI",Dickinson County, MI,2011,12810,11581,1229,9.6
26,45,"Eaton County, MI",Eaton County, MI,2011,55660,51191,4469,8
26,47,"Emmet County, MI",Emmet County, MI,2011,18043,15684,2359,13.1
26,49,"Genesee County, MI",Genesee County, MI,2011,182814,161919,20895,11.4
26,51,"Gladwin County, MI",Gladwin County, MI,2011,10115,8799,1316,13
26,53,"Gogebic County, MI",Gogebic County, MI,2011,6947,6122,825,11.9
26,55,"Grand Traverse County, MI",Grand Traverse County, MI,2011,46656,42083,4573,9.8
26,57,"Gratiot County, MI",Gratiot County, MI,2011,19075,17162,1913,10
26,59,"Hillsdale County, MI",Hillsdale County, MI,2011,20651,18454,2197,10.6
26,61,"Houghton County, MI",Houghton County, MI,2011,17322,15662,1660,9.6
26,63,"Huron County, MI",Huron County, MI,2011,16412,14815,1597,9.7
26,65,"Ingham County, MI",Ingham County, MI,2011,145123,132289,12834,8.8
26,67,"Ionia County, MI",Ionia County, MI,2011,29106,26261,2845,9.8
26,69,"Iosco County, MI",Iosco County, MI,2011,10130,8830,1300,12.8
26,71,"Iron County, MI",Iron County, MI,2011,5170,4634,536,10.4
26,73,"Isabella County, MI",Isabella County, MI,2011,34911,31986,2925,8.4
26,75,"Jackson County, MI",Jackson County, MI,2011,72614,65424,7190,9.9
26,77,"Kalamazoo County, MI",Kalamazoo County, MI,2011,126186,115549,10637,8.4
26,79,"Kalkaska County, MI",Kalkaska County, MI,2011,7595,6606,989,13
26,81,"Kent County, MI",Kent County, MI,2011,315111,289297,25814,8.2
26,83,"Keweenaw County, MI",Keweenaw County, MI,2011,1017,877,140,13.8
26,85,"Lake County, MI",Lake County, MI,2011,3858,3331,527,13.7
26,87,"Lapeer County, MI",Lapeer County, MI,2011,39862,34587,5275,13.2
26,89,"Leelanau County, MI",Leelanau County, MI,2011,10324,9378,946,9.2
26,91,"Lenawee County, MI",Lenawee County, MI,2011,48269,43261,5008,10.4
26,93,"Livingston County, MI",Livingston County, MI,2011,92626,84286,8340,9
26,95,"Luce County, MI",Luce County, MI,2011,2412,2117,295,12.2
26,97,"Mackinac County, MI",Mackinac County, MI,2011,5289,4595,694,13.1
26,99,"Macomb County, MI",Macomb County, MI,2011,409065,363484,45581,11.1
26,101,"Manistee County, MI",Manistee County, MI,2011,10684,9406,1278,12
26,103,"Marquette County, MI",Marquette County, MI,2011,33939,30923,3016,8.9
26,105,"Mason County, MI",Mason County, MI,2011,14263,12694,1569,11
26,107,"Mecosta County, MI",Mecosta County, MI,2011,19137,16974,2163,11.3
26,109,"Menominee County, MI",Menominee County, MI,2011,11815,10736,1079,9.1
26,111,"Midland County, MI",Midland County, MI,2011,40869,37450,3419,8.4
26,113,"Missaukee County, MI",Missaukee County, MI,2011,7037,6272,765,10.9
26,115,"Monroe County, MI",Monroe County, MI,2011,73660,66681,6979,9.5
26,117,"Montcalm County, MI",Montcalm County, MI,2011,27300,24140,3160,11.6
26,119,"Montmorency County, MI",Montmorency County, MI,2011,3346,2742,604,18.1
26,121,"Muskegon County, MI",Muskegon County, MI,2011,75669,67008,8661,11.4
26,123,"Newaygo County, MI",Newaygo County, MI,2011,22463,20074,2389,10.6
26,125,"Oakland County, MI",Oakland County, MI,2011,610881,552660,58221,9.5
26,127,"Oceana County, MI",Oceana County, MI,2011,12988,11165,1823,14
26,129,"Ogemaw County, MI",Ogemaw County, MI,2011,8786,7663,1123,12.8
26,131,"Ontonagon County, MI",Ontonagon County, MI,2011,2777,2326,451,16.2
26,133,"Osceola County, MI",Osceola County, MI,2011,10170,9012,1158,11.4
26,135,"Oscoda County, MI",Oscoda County, MI,2011,3149,2589,560,17.8
26,137,"Otsego County, MI",Otsego County, MI,2011,11452,10058,1394,12.2
26,139,"Ottawa County, MI",Ottawa County, MI,2011,139598,128452,11146,8
26,141,"Presque Isle County, MI",Presque Isle County, MI,2011,5569,4673,896,16.1
26,143,"Roscommon County, MI",Roscommon County, MI,2011,8383,7143,1240,14.8
26,145,"Saginaw County, MI",Saginaw County, MI,2011,89803,80647,9156,10.2
26,147,"St. Clair County, MI",St. Clair County, MI,2011,74208,64509,9699,13.1
26,149,"St. Joseph County, MI",St. Joseph County, MI,2011,27609,24606,3003,10.9
26,151,"Sanilac County, MI",Sanilac County, MI,2011,19505,17119,2386,12.2
26,153,"Schoolcraft County, MI",Schoolcraft County, MI,2011,3678,3189,489,13.3
26,155,"Shiawassee County, MI",Shiawassee County, MI,2011,33632,30023,3609,10.7
26,157,"Tuscola County, MI",Tuscola County, MI,2011,25165,22145,3020,12
26,159,"Van Buren County, MI",Van Buren County, MI,2011,36445,32241,4204,11.5
26,161,"Washtenaw County, MI",Washtenaw County, MI,2011,180797,168467,12330,6.8
26,163,"Wayne County, MI",Wayne County, MI,2011,774443,674177,100266,12.9
26,165,"Wexford County, MI",Wexford County, MI,2011,14656,12870,1786,12.2
27,1,"Aitkin County, MN",Aitkin County, MN,2011,7112,6431,681,9.6
27,3,"Anoka County, MN",Anoka County, MN,2011,187000,174217,12783,6.8
27,5,"Becker County, MN",Becker County, MN,2011,17715,16451,1264,7.1
27,7,"Beltrami County, MN",Beltrami County, MN,2011,22491,20650,1841,8.2
27,9,"Benton County, MN",Benton County, MN,2011,21250,19645,1605,7.6
27,11,"Big Stone County, MN",Big Stone County, MN,2011,2902,2715,187,6.4
27,13,"Blue Earth County, MN",Blue Earth County, MN,2011,38315,36245,2070,5.4
27,15,"Brown County, MN",Brown County, MN,2011,15042,14157,885,5.9
27,17,"Carlton County, MN",Carlton County, MN,2011,17630,16286,1344,7.6
27,19,"Carver County, MN",Carver County, MN,2011,52129,49252,2877,5.5
27,21,"Cass County, MN",Cass County, MN,2011,14149,12730,1419,10
27,23,"Chippewa County, MN",Chippewa County, MN,2011,7183,6730,453,6.3
27,25,"Chisago County, MN",Chisago County, MN,2011,28983,26777,2206,7.6
27,27,"Clay County, MN",Clay County, MN,2011,34623,32703,1920,5.5
27,29,"Clearwater County, MN",Clearwater County, MN,2011,4573,4030,543,11.9
27,31,"Cook County, MN",Cook County, MN,2011,3051,2842,209,6.9
27,33,"Cottonwood County, MN",Cottonwood County, MN,2011,6139,5762,377,6.1
27,35,"Crow Wing County, MN",Crow Wing County, MN,2011,31556,28798,2758,8.7
27,37,"Dakota County, MN",Dakota County, MN,2011,227975,214174,13801,6.1
27,39,"Dodge County, MN",Dodge County, MN,2011,11235,10559,676,6
27,41,"Douglas County, MN",Douglas County, MN,2011,19780,18584,1196,6
27,43,"Faribault County, MN",Faribault County, MN,2011,7794,7242,552,7.1
27,45,"Fillmore County, MN",Fillmore County, MN,2011,11224,10479,745,6.6
27,47,"Freeborn County, MN",Freeborn County, MN,2011,17051,15919,1132,6.6
27,49,"Goodhue County, MN",Goodhue County, MN,2011,26931,25318,1613,6
27,51,"Grant County, MN",Grant County, MN,2011,3375,3142,233,6.9
27,53,"Hennepin County, MN",Hennepin County, MN,2011,656064,616332,39732,6.1
27,55,"Houston County, MN",Houston County, MN,2011,10665,9930,735,6.9
27,57,"Hubbard County, MN",Hubbard County, MN,2011,9512,8638,874,9.2
27,59,"Isanti County, MN",Isanti County, MN,2011,20589,18874,1715,8.3
27,61,"Itasca County, MN",Itasca County, MN,2011,22519,20478,2041,9.1
27,63,"Jackson County, MN",Jackson County, MN,2011,6090,5760,330,5.4
27,65,"Kanabec County, MN",Kanabec County, MN,2011,8709,7834,875,10
27,67,"Kandiyohi County, MN",Kandiyohi County, MN,2011,23643,22229,1414,6
27,69,"Kittson County, MN",Kittson County, MN,2011,2604,2426,178,6.8
27,71,"Koochiching County, MN",Koochiching County, MN,2011,6811,6242,569,8.4
27,73,"Lac qui Parle County, MN",Lac qui Parle County, MN,2011,3974,3733,241,6.1
27,75,"Lake County, MN",Lake County, MN,2011,5814,5414,400,6.9
27,77,"Lake of the Woods County, MN",Lake of the Woods County, MN,2011,2339,2194,145,6.2
27,79,"Le Sueur County, MN",Le Sueur County, MN,2011,15684,14494,1190,7.6
27,81,"Lincoln County, MN",Lincoln County, MN,2011,3448,3270,178,5.2
27,83,"Lyon County, MN",Lyon County, MN,2011,15396,14586,810,5.3
27,85,"McLeod County, MN",McLeod County, MN,2011,20344,18789,1555,7.6
27,87,"Mahnomen County, MN",Mahnomen County, MN,2011,2493,2304,189,7.6
27,89,"Marshall County, MN",Marshall County, MN,2011,5787,5304,483,8.3
27,91,"Martin County, MN",Martin County, MN,2011,11212,10468,744,6.6
27,93,"Meeker County, MN",Meeker County, MN,2011,12844,11853,991,7.7
27,95,"Mille Lacs County, MN",Mille Lacs County, MN,2011,12924,11683,1241,9.6
27,97,"Morrison County, MN",Morrison County, MN,2011,18752,17210,1542,8.2
27,99,"Mower County, MN",Mower County, MN,2011,20818,19641,1177,5.7
27,101,"Murray County, MN",Murray County, MN,2011,5039,4725,314,6.2
27,103,"Nicollet County, MN",Nicollet County, MN,2011,19939,18924,1015,5.1
27,105,"Nobles County, MN",Nobles County, MN,2011,11485,10880,605,5.3
27,107,"Norman County, MN",Norman County, MN,2011,3649,3405,244,6.7
27,109,"Olmsted County, MN",Olmsted County, MN,2011,81313,77037,4276,5.3
27,111,"Otter Tail County, MN",Otter Tail County, MN,2011,30890,28916,1974,6.4
27,113,"Pennington County, MN",Pennington County, MN,2011,8559,7903,656,7.7
27,115,"Pine County, MN",Pine County, MN,2011,15150,13817,1333,8.8
27,117,"Pipestone County, MN",Pipestone County, MN,2011,5031,4704,327,6.5
27,119,"Polk County, MN",Polk County, MN,2011,17420,16196,1224,7
27,121,"Pope County, MN",Pope County, MN,2011,5860,5515,345,5.9
27,123,"Ramsey County, MN",Ramsey County, MN,2011,272394,254310,18084,6.6
27,125,"Red Lake County, MN",Red Lake County, MN,2011,2424,2228,196,8.1
27,127,"Redwood County, MN",Redwood County, MN,2011,8385,7878,507,6
27,129,"Renville County, MN",Renville County, MN,2011,8545,7919,626,7.3
27,131,"Rice County, MN",Rice County, MN,2011,34771,32464,2307,6.6
27,133,"Rock County, MN",Rock County, MN,2011,5615,5378,237,4.2
27,135,"Roseau County, MN",Roseau County, MN,2011,8528,8072,456,5.3
27,137,"St. Louis County, MN",St. Louis County, MN,2011,102271,94758,7513,7.3
27,139,"Scott County, MN",Scott County, MN,2011,74896,70578,4318,5.8
27,141,"Sherburne County, MN",Sherburne County, MN,2011,48872,45383,3489,7.1
27,143,"Sibley County, MN",Sibley County, MN,2011,8500,7915,585,6.9
27,145,"Stearns County, MN",Stearns County, MN,2011,85989,80611,5378,6.3
27,147,"Steele County, MN",Steele County, MN,2011,21118,19753,1365,6.5
27,149,"Stevens County, MN",Stevens County, MN,2011,5587,5315,272,4.9
27,151,"Swift County, MN",Swift County, MN,2011,5194,4823,371,7.1
27,153,"Todd County, MN",Todd County, MN,2011,13296,12393,903,6.8
27,155,"Traverse County, MN",Traverse County, MN,2011,1843,1733,110,6
27,157,"Wabasha County, MN",Wabasha County, MN,2011,11954,11217,737,6.2
27,159,"Wadena County, MN",Wadena County, MN,2011,6319,5750,569,9
27,161,"Waseca County, MN",Waseca County, MN,2011,10582,9916,666,6.3
27,163,"Washington County, MN",Washington County, MN,2011,133063,125221,7842,5.9
27,165,"Watonwan County, MN",Watonwan County, MN,2011,6267,5871,396,6.3
27,167,"Wilkin County, MN",Wilkin County, MN,2011,3818,3605,213,5.6
27,169,"Winona County, MN",Winona County, MN,2011,29435,27721,1714,5.8
27,171,"Wright County, MN",Wright County, MN,2011,70299,65495,4804,6.8
27,173,"Yellow Medicine County, MN",Yellow Medicine County, MN,2011,5743,5415,328,5.7
28,1,"Adams County, MS",Adams County, MS,2011,12914,11523,1391,10.8
28,3,"Alcorn County, MS",Alcorn County, MS,2011,16197,14435,1762,10.9
28,5,"Amite County, MS",Amite County, MS,2011,4991,4421,570,11.4
28,7,"Attala County, MS",Attala County, MS,2011,7969,7090,879,11
28,9,"Benton County, MS",Benton County, MS,2011,3386,2969,417,12.3
28,11,"Bolivar County, MS",Bolivar County, MS,2011,15024,13348,1676,11.2
28,13,"Calhoun County, MS",Calhoun County, MS,2011,7111,6495,616,8.7
28,15,"Carroll County, MS",Carroll County, MS,2011,3801,3341,460,12.1
28,17,"Chickasaw County, MS",Chickasaw County, MS,2011,8259,7312,947,11.5
28,19,"Choctaw County, MS",Choctaw County, MS,2011,3795,3419,376,9.9
28,21,"Claiborne County, MS",Claiborne County, MS,2011,3691,3102,589,16
28,23,"Clarke County, MS",Clarke County, MS,2011,6755,5958,797,11.8
28,25,"Clay County, MS",Clay County, MS,2011,8693,7401,1292,14.9
28,27,"Coahoma County, MS",Coahoma County, MS,2011,10685,9206,1479,13.8
28,29,"Copiah County, MS",Copiah County, MS,2011,12259,10840,1419,11.6
28,31,"Covington County, MS",Covington County, MS,2011,8527,7738,789,9.3
28,33,"DeSoto County, MS",DeSoto County, MS,2011,83141,77164,5977,7.2
28,35,"Forrest County, MS",Forrest County, MS,2011,35074,31522,3552,10.1
28,37,"Franklin County, MS",Franklin County, MS,2011,3219,2870,349,10.8
28,39,"George County, MS",George County, MS,2011,9060,7954,1106,12.2
28,41,"Greene County, MS",Greene County, MS,2011,4691,4125,566,12.1
28,43,"Grenada County, MS",Grenada County, MS,2011,9707,8715,992,10.2
28,45,"Hancock County, MS",Hancock County, MS,2011,20061,18157,1904,9.5
28,47,"Harrison County, MS",Harrison County, MS,2011,90567,82496,8071,8.9
28,49,"Hinds County, MS",Hinds County, MS,2011,118306,107045,11261,9.5
28,51,"Holmes County, MS",Holmes County, MS,2011,6897,5661,1236,17.9
28,53,"Humphreys County, MS",Humphreys County, MS,2011,3427,2789,638,18.6
28,55,"Issaquena County, MS",Issaquena County, MS,2011,508,412,96,18.9
28,57,"Itawamba County, MS",Itawamba County, MS,2011,10571,9516,1055,10
28,59,"Jackson County, MS",Jackson County, MS,2011,65570,58738,6832,10.4
28,61,"Jasper County, MS",Jasper County, MS,2011,7180,6359,821,11.4
28,63,"Jefferson County, MS",Jefferson County, MS,2011,2537,2067,470,18.5
28,65,"Jefferson Davis County, MS",Jefferson Davis County, MS,2011,4624,3991,633,13.7
28,67,"Jones County, MS",Jones County, MS,2011,29122,26630,2492,8.6
28,69,"Kemper County, MS",Kemper County, MS,2011,3914,3358,556,14.2
28,71,"Lafayette County, MS",Lafayette County, MS,2011,22927,20961,1966,8.6
28,73,"Lamar County, MS",Lamar County, MS,2011,28502,26473,2029,7.1
28,75,"Lauderdale County, MS",Lauderdale County, MS,2011,34383,30858,3525,10.3
28,77,"Lawrence County, MS",Lawrence County, MS,2011,5084,4487,597,11.7
28,79,"Leake County, MS",Leake County, MS,2011,8871,8007,864,9.7
28,81,"Lee County, MS",Lee County, MS,2011,41067,37105,3962,9.6
28,83,"Leflore County, MS",Leflore County, MS,2011,11625,9895,1730,14.9
28,85,"Lincoln County, MS",Lincoln County, MS,2011,14829,13383,1446,9.8
28,87,"Lowndes County, MS",Lowndes County, MS,2011,27320,24446,2874,10.5
28,89,"Madison County, MS",Madison County, MS,2011,50718,47222,3496,6.9
28,91,"Marion County, MS",Marion County, MS,2011,10926,9756,1170,10.7
28,93,"Marshall County, MS",Marshall County, MS,2011,15774,13927,1847,11.7
28,95,"Monroe County, MS",Monroe County, MS,2011,16575,14580,1995,12
28,97,"Montgomery County, MS",Montgomery County, MS,2011,4678,4097,581,12.4
28,99,"Neshoba County, MS",Neshoba County, MS,2011,11969,10855,1114,9.3
28,101,"Newton County, MS",Newton County, MS,2011,9397,8526,871,9.3
28,103,"Noxubee County, MS",Noxubee County, MS,2011,4375,3742,633,14.5
28,105,"Oktibbeha County, MS",Oktibbeha County, MS,2011,22772,20594,2178,9.6
28,107,"Panola County, MS",Panola County, MS,2011,14709,12768,1941,13.2
28,109,"Pearl River County, MS",Pearl River County, MS,2011,24312,22044,2268,9.3
28,111,"Perry County, MS",Perry County, MS,2011,4669,4054,615,13.2
28,113,"Pike County, MS",Pike County, MS,2011,15766,13942,1824,11.6
28,115,"Pontotoc County, MS",Pontotoc County, MS,2011,14019,12710,1309,9.3
28,117,"Prentiss County, MS",Prentiss County, MS,2011,11731,10511,1220,10.4
28,119,"Quitman County, MS",Quitman County, MS,2011,3118,2658,460,14.8
28,121,"Rankin County, MS",Rankin County, MS,2011,73496,68814,4682,6.4
28,123,"Scott County, MS",Scott County, MS,2011,13669,12513,1156,8.5
28,125,"Sharkey County, MS",Sharkey County, MS,2011,2032,1729,303,14.9
28,127,"Simpson County, MS",Simpson County, MS,2011,11576,10522,1054,9.1
28,129,"Smith County, MS",Smith County, MS,2011,7407,6792,615,8.3
28,131,"Stone County, MS",Stone County, MS,2011,7042,6283,759,10.8
28,133,"Sunflower County, MS",Sunflower County, MS,2011,9851,8363,1488,15.1
28,135,"Tallahatchie County, MS",Tallahatchie County, MS,2011,6073,5341,732,12.1
28,137,"Tate County, MS",Tate County, MS,2011,12834,11504,1330,10.4
28,139,"Tippah County, MS",Tippah County, MS,2011,9289,8191,1098,11.8
28,141,"Tishomingo County, MS",Tishomingo County, MS,2011,8068,7097,971,12
28,143,"Tunica County, MS",Tunica County, MS,2011,5144,4396,748,14.5
28,145,"Union County, MS",Union County, MS,2011,13302,11980,1322,9.9
28,147,"Walthall County, MS",Walthall County, MS,2011,5824,5124,700,12
28,149,"Warren County, MS",Warren County, MS,2011,23541,21148,2393,10.2
28,151,"Washington County, MS",Washington County, MS,2011,21178,17894,3284,15.5
28,153,"Wayne County, MS",Wayne County, MS,2011,8741,7745,996,11.4
28,155,"Webster County, MS",Webster County, MS,2011,4403,3941,462,10.5
28,157,"Wilkinson County, MS",Wilkinson County, MS,2011,3456,3008,448,13
28,159,"Winston County, MS",Winston County, MS,2011,8015,6936,1079,13.5
28,161,"Yalobusha County, MS",Yalobusha County, MS,2011,5377,4740,637,11.8
28,163,"Yazoo County, MS",Yazoo County, MS,2011,10143,8920,1223,12.1
29,1,"Adair County, MO",Adair County, MO,2011,10917,9981,936,8.6
29,3,"Andrew County, MO",Andrew County, MO,2011,9753,9077,676,6.9
29,5,"Atchison County, MO",Atchison County, MO,2011,2894,2657,237,8.2
29,7,"Audrain County, MO",Audrain County, MO,2011,11294,10368,926,8.2
29,9,"Barry County, MO",Barry County, MO,2011,15264,13895,1369,9
29,11,"Barton County, MO",Barton County, MO,2011,5636,5140,496,8.8
29,13,"Bates County, MO",Bates County, MO,2011,8385,7539,846,10.1
29,15,"Benton County, MO",Benton County, MO,2011,7228,6439,789,10.9
29,17,"Bollinger County, MO",Bollinger County, MO,2011,5757,5239,518,9
29,19,"Boone County, MO",Boone County, MO,2011,94108,88736,5372,5.7
29,21,"Buchanan County, MO",Buchanan County, MO,2011,46473,42713,3760,8.1
29,23,"Butler County, MO",Butler County, MO,2011,18816,17122,1694,9
29,25,"Caldwell County, MO",Caldwell County, MO,2011,4450,4064,386,8.7
29,27,"Callaway County, MO",Callaway County, MO,2011,22085,20405,1680,7.6
29,29,"Camden County, MO",Camden County, MO,2011,19150,17015,2135,11.1
29,31,"Cape Girardeau County, MO",Cape Girardeau County, MO,2011,40687,37944,2743,6.7
29,33,"Carroll County, MO",Carroll County, MO,2011,4743,4247,496,10.5
29,35,"Carter County, MO",Carter County, MO,2011,2640,2342,298,11.3
29,37,"Cass County, MO",Cass County, MO,2011,53085,48586,4499,8.5
29,39,"Cedar County, MO",Cedar County, MO,2011,6002,5480,522,8.7
29,41,"Chariton County, MO",Chariton County, MO,2011,4098,3731,367,9
29,43,"Christian County, MO",Christian County, MO,2011,40908,37869,3039,7.4
29,45,"Clark County, MO",Clark County, MO,2011,3405,3064,341,10
29,47,"Clay County, MO",Clay County, MO,2011,125652,116366,9286,7.4
29,49,"Clinton County, MO",Clinton County, MO,2011,11033,10050,983,8.9
29,51,"Cole County, MO",Cole County, MO,2011,40384,37846,2538,6.3
29,53,"Cooper County, MO",Cooper County, MO,2011,7948,7231,717,9
29,55,"Crawford County, MO",Crawford County, MO,2011,10856,9676,1180,10.9
29,57,"Dade County, MO",Dade County, MO,2011,3433,3114,319,9.3
29,59,"Dallas County, MO",Dallas County, MO,2011,7226,6429,797,11
29,61,"Daviess County, MO",Daviess County, MO,2011,4056,3695,361,8.9
29,63,"DeKalb County, MO",DeKalb County, MO,2011,5035,4632,403,8
29,65,"Dent County, MO",Dent County, MO,2011,6418,5796,622,9.7
29,67,"Douglas County, MO",Douglas County, MO,2011,5196,4666,530,10.2
29,69,"Dunklin County, MO",Dunklin County, MO,2011,12350,10853,1497,12.1
29,71,"Franklin County, MO",Franklin County, MO,2011,52944,47965,4979,9.4
29,73,"Gasconade County, MO",Gasconade County, MO,2011,7633,6958,675,8.8
29,75,"Gentry County, MO",Gentry County, MO,2011,3587,3338,249,6.9
29,77,"Greene County, MO",Greene County, MO,2011,144414,133822,10592,7.3
29,79,"Grundy County, MO",Grundy County, MO,2011,4955,4604,351,7.1
29,81,"Harrison County, MO",Harrison County, MO,2011,4021,3679,342,8.5
29,83,"Henry County, MO",Henry County, MO,2011,9923,8965,958,9.7
29,85,"Hickory County, MO",Hickory County, MO,2011,3572,3155,417,11.7
29,87,"Holt County, MO",Holt County, MO,2011,2701,2506,195,7.2
29,89,"Howard County, MO",Howard County, MO,2011,4866,4465,401,8.2
29,91,"Howell County, MO",Howell County, MO,2011,16532,14948,1584,9.6
29,93,"Iron County, MO",Iron County, MO,2011,3570,3068,502,14.1
29,95,"Jackson County, MO",Jackson County, MO,2011,358230,324169,34061,9.5
29,97,"Jasper County, MO",Jasper County, MO,2011,58850,54387,4463,7.6
29,99,"Jefferson County, MO",Jefferson County, MO,2011,116930,106665,10265,8.8
29,101,"Johnson County, MO",Johnson County, MO,2011,23500,21356,2144,9.1
29,103,"Knox County, MO",Knox County, MO,2011,1979,1837,142,7.2
29,105,"Laclede County, MO",Laclede County, MO,2011,15921,14122,1799,11.3
29,107,"Lafayette County, MO",Lafayette County, MO,2011,17464,15875,1589,9.1
29,109,"Lawrence County, MO",Lawrence County, MO,2011,17396,15949,1447,8.3
29,111,"Lewis County, MO",Lewis County, MO,2011,5142,4784,358,7
29,113,"Lincoln County, MO",Lincoln County, MO,2011,26691,24003,2688,10.1
29,115,"Linn County, MO",Linn County, MO,2011,5335,4701,634,11.9
29,117,"Livingston County, MO",Livingston County, MO,2011,7090,6553,537,7.6
29,119,"McDonald County, MO",McDonald County, MO,2011,10239,9384,855,8.4
29,121,"Macon County, MO",Macon County, MO,2011,7489,6870,619,8.3
29,123,"Madison County, MO",Madison County, MO,2011,5361,4803,558,10.4
29,125,"Maries County, MO",Maries County, MO,2011,4207,3852,355,8.4
29,127,"Marion County, MO",Marion County, MO,2011,14547,13459,1088,7.5
29,129,"Mercer County, MO",Mercer County, MO,2011,1838,1715,123,6.7
29,131,"Miller County, MO",Miller County, MO,2011,11381,10077,1304,11.5
29,133,"Mississippi County, MO",Mississippi County, MO,2011,6072,5488,584,9.6
29,135,"Moniteau County, MO",Moniteau County, MO,2011,7374,6809,565,7.7
29,137,"Monroe County, MO",Monroe County, MO,2011,4093,3689,404,9.9
29,139,"Montgomery County, MO",Montgomery County, MO,2011,5954,5363,591,9.9
29,141,"Morgan County, MO",Morgan County, MO,2011,7874,6878,996,12.6
29,143,"New Madrid County, MO",New Madrid County, MO,2011,8236,7436,800,9.7
29,145,"Newton County, MO",Newton County, MO,2011,28981,26668,2313,8
29,147,"Nodaway County, MO",Nodaway County, MO,2011,11602,10805,797,6.9
29,149,"Oregon County, MO",Oregon County, MO,2011,4063,3665,398,9.8
29,151,"Osage County, MO",Osage County, MO,2011,7424,6965,459,6.2
29,153,"Ozark County, MO",Ozark County, MO,2011,3580,3157,423,11.8
29,155,"Pemiscot County, MO",Pemiscot County, MO,2011,7193,6355,838,11.7
29,157,"Perry County, MO",Perry County, MO,2011,9873,9216,657,6.7
29,159,"Pettis County, MO",Pettis County, MO,2011,20169,18505,1664,8.3
29,161,"Phelps County, MO",Phelps County, MO,2011,19933,18252,1681,8.4
29,163,"Pike County, MO",Pike County, MO,2011,8208,7524,684,8.3
29,165,"Platte County, MO",Platte County, MO,2011,52035,48433,3602,6.9
29,167,"Polk County, MO",Polk County, MO,2011,14326,12989,1337,9.3
29,169,"Pulaski County, MO",Pulaski County, MO,2011,16671,15222,1449,8.7
29,171,"Putnam County, MO",Putnam County, MO,2011,2372,2211,161,6.8
29,173,"Ralls County, MO",Ralls County, MO,2011,5648,5225,423,7.5
29,175,"Randolph County, MO",Randolph County, MO,2011,10817,9682,1135,10.5
29,177,"Ray County, MO",Ray County, MO,2011,11438,10376,1062,9.3
29,179,"Reynolds County, MO",Reynolds County, MO,2011,2319,2013,306,13.2
29,181,"Ripley County, MO",Ripley County, MO,2011,5487,4831,656,12
29,183,"St. Charles County, MO",St. Charles County, MO,2011,206298,192073,14225,6.9
29,185,"St. Clair County, MO",St. Clair County, MO,2011,4023,3617,406,10.1
29,186,"Ste. Genevieve County, MO",Ste. Genevieve County, MO,2011,9316,8454,862,9.3
29,187,"St. Francois County, MO",St. Francois County, MO,2011,26794,23899,2895,10.8
29,189,"St. Louis County, MO",St. Louis County, MO,2011,534224,492327,41897,7.8
29,195,"Saline County, MO",Saline County, MO,2011,11121,10231,890,8
29,197,"Schuyler County, MO",Schuyler County, MO,2011,1908,1734,174,9.1
29,199,"Scotland County, MO",Scotland County, MO,2011,2332,2178,154,6.6
29,201,"Scott County, MO",Scott County, MO,2011,19679,17950,1729,8.8
29,203,"Shannon County, MO",Shannon County, MO,2011,3134,2722,412,13.1
29,205,"Shelby County, MO",Shelby County, MO,2011,3205,2975,230,7.2
29,207,"Stoddard County, MO",Stoddard County, MO,2011,13700,12326,1374,10
29,209,"Stone County, MO",Stone County, MO,2011,14181,12399,1782,12.6
29,211,"Sullivan County, MO",Sullivan County, MO,2011,2837,2600,237,8.4
29,213,"Taney County, MO",Taney County, MO,2011,26143,22699,3444,13.2
29,215,"Texas County, MO",Texas County, MO,2011,9767,8817,950,9.7
29,217,"Vernon County, MO",Vernon County, MO,2011,9598,8904,694,7.2
29,219,"Warren County, MO",Warren County, MO,2011,17114,15559,1555,9.1
29,221,"Washington County, MO",Washington County, MO,2011,10139,8901,1238,12.2
29,223,"Wayne County, MO",Wayne County, MO,2011,5500,4942,558,10.1
29,225,"Webster County, MO",Webster County, MO,2011,16180,14736,1444,8.9
29,227,"Worth County, MO",Worth County, MO,2011,1241,1170,71,5.7
29,229,"Wright County, MO",Wright County, MO,2011,7605,6859,746,9.8
29,510,"St. Louis city, MO",St. Louis city, MO,2011,164340,147357,16983,10.3
30,1,"Beaverhead County, MT",Beaverhead County, MT,2011,4934,4633,301,6.1
30,3,"Big Horn County, MT",Big Horn County, MT,2011,5638,4961,677,12
30,5,"Blaine County, MT",Blaine County, MT,2011,2486,2309,177,7.1
30,7,"Broadwater County, MT",Broadwater County, MT,2011,2494,2310,184,7.4
30,9,"Carbon County, MT",Carbon County, MT,2011,5292,4988,304,5.7
30,11,"Carter County, MT",Carter County, MT,2011,684,657,27,3.9
30,13,"Cascade County, MT",Cascade County, MT,2011,38333,35882,2451,6.4
30,15,"Chouteau County, MT",Chouteau County, MT,2011,2652,2531,121,4.6
30,17,"Custer County, MT",Custer County, MT,2011,6367,6108,259,4.1
30,19,"Daniels County, MT",Daniels County, MT,2011,943,910,33,3.5
30,21,"Dawson County, MT",Dawson County, MT,2011,4547,4381,166,3.7
30,23,"Deer Lodge County, MT",Deer Lodge County, MT,2011,5156,4837,319,6.2
30,25,"Fallon County, MT",Fallon County, MT,2011,1952,1901,51,2.6
30,27,"Fergus County, MT",Fergus County, MT,2011,5906,5546,360,6.1
30,29,"Flathead County, MT",Flathead County, MT,2011,43591,38821,4770,10.9
30,31,"Gallatin County, MT",Gallatin County, MT,2011,51559,48461,3098,6
30,33,"Garfield County, MT",Garfield County, MT,2011,777,747,30,3.9
30,35,"Glacier County, MT",Glacier County, MT,2011,6061,5372,689,11.4
30,37,"Golden Valley County, MT",Golden Valley County, MT,2011,391,371,20,5.1
30,39,"Granite County, MT",Granite County, MT,2011,1457,1325,132,9.1
30,41,"Hill County, MT",Hill County, MT,2011,7986,7486,500,6.3
30,43,"Jefferson County, MT",Jefferson County, MT,2011,5619,5267,352,6.3
30,45,"Judith Basin County, MT",Judith Basin County, MT,2011,968,908,60,6.2
30,47,"Lake County, MT",Lake County, MT,2011,12553,11409,1144,9.1
30,49,"Lewis and Clark County, MT",Lewis and Clark County, MT,2011,34503,32668,1835,5.3
30,51,"Liberty County, MT",Liberty County, MT,2011,1018,977,41,4
30,53,"Lincoln County, MT",Lincoln County, MT,2011,8212,6996,1216,14.8
30,55,"McCone County, MT",McCone County, MT,2011,1098,1065,33,3
30,57,"Madison County, MT",Madison County, MT,2011,4178,3872,306,7.3
30,59,"Meagher County, MT",Meagher County, MT,2011,910,843,67,7.4
30,61,"Mineral County, MT",Mineral County, MT,2011,1791,1574,217,12.1
30,63,"Missoula County, MT",Missoula County, MT,2011,58780,54816,3964,6.7
30,65,"Musselshell County, MT",Musselshell County, MT,2011,2329,2175,154,6.6
30,67,"Park County, MT",Park County, MT,2011,7883,7229,654,8.3
30,69,"Petroleum County, MT",Petroleum County, MT,2011,280,264,16,5.7
30,71,"Phillips County, MT",Phillips County, MT,2011,2126,1979,147,6.9
30,73,"Pondera County, MT",Pondera County, MT,2011,2930,2753,177,6
30,75,"Powder River County, MT",Powder River County, MT,2011,1058,1008,50,4.7
30,77,"Powell County, MT",Powell County, MT,2011,2990,2761,229,7.7
30,79,"Prairie County, MT",Prairie County, MT,2011,531,502,29,5.5
30,81,"Ravalli County, MT",Ravalli County, MT,2011,18660,16985,1675,9
30,83,"Richland County, MT",Richland County, MT,2011,6151,5961,190,3.1
30,85,"Roosevelt County, MT",Roosevelt County, MT,2011,4629,4301,328,7.1
30,87,"Rosebud County, MT",Rosebud County, MT,2011,4445,4121,324,7.3
30,89,"Sanders County, MT",Sanders County, MT,2011,4861,4212,649,13.4
30,91,"Sheridan County, MT",Sheridan County, MT,2011,1885,1818,67,3.6
30,93,"Silver Bow County, MT",Silver Bow County, MT,2011,16956,15838,1118,6.6
30,95,"Stillwater County, MT",Stillwater County, MT,2011,4824,4573,251,5.2
30,97,"Sweet Grass County, MT",Sweet Grass County, MT,2011,1703,1623,80,4.7
30,99,"Teton County, MT",Teton County, MT,2011,2941,2774,167,5.7
30,101,"Toole County, MT",Toole County, MT,2011,2387,2276,111,4.7
30,103,"Treasure County, MT",Treasure County, MT,2011,378,357,21,5.6
30,105,"Valley County, MT",Valley County, MT,2011,3937,3752,185,4.7
30,107,"Wheatland County, MT",Wheatland County, MT,2011,837,770,67,8
30,109,"Wibaux County, MT",Wibaux County, MT,2011,526,504,22,4.2
30,111,"Yellowstone County, MT",Yellowstone County, MT,2011,77147,72938,4209,5.5
31,1,"Adams County, NE",Adams County, NE,2011,16487,15777,710,4.3
31,3,"Antelope County, NE",Antelope County, NE,2011,3598,3467,131,3.6
31,5,"Arthur County, NE",Arthur County, NE,2011,231,217,14,6.1
31,7,"Banner County, NE",Banner County, NE,2011,433,413,20,4.6
31,9,"Blaine County, NE",Blaine County, NE,2011,280,265,15,5.4
31,11,"Boone County, NE",Boone County, NE,2011,3041,2930,111,3.7
31,13,"Box Butte County, NE",Box Butte County, NE,2011,5981,5728,253,4.2
31,15,"Boyd County, NE",Boyd County, NE,2011,1149,1105,44,3.8
31,17,"Brown County, NE",Brown County, NE,2011,1464,1397,67,4.6
31,19,"Buffalo County, NE",Buffalo County, NE,2011,26864,25922,942,3.5
31,21,"Burt County, NE",Burt County, NE,2011,3638,3429,209,5.7
31,23,"Butler County, NE",Butler County, NE,2011,4745,4566,179,3.8
31,25,"Cass County, NE",Cass County, NE,2011,13380,12679,701,5.2
31,27,"Cedar County, NE",Cedar County, NE,2011,4709,4554,155,3.3
31,29,"Chase County, NE",Chase County, NE,2011,2346,2289,57,2.4
31,31,"Cherry County, NE",Cherry County, NE,2011,3453,3348,105,3
31,33,"Cheyenne County, NE",Cheyenne County, NE,2011,5684,5511,173,3
31,35,"Clay County, NE",Clay County, NE,2011,3483,3339,144,4.1
31,37,"Colfax County, NE",Colfax County, NE,2011,5684,5464,220,3.9
31,39,"Cuming County, NE",Cuming County, NE,2011,4924,4756,168,3.4
31,41,"Custer County, NE",Custer County, NE,2011,6048,5842,206,3.4
31,43,"Dakota County, NE",Dakota County, NE,2011,11014,10366,648,5.9
31,45,"Dawes County, NE",Dawes County, NE,2011,5473,5261,212,3.9
31,47,"Dawson County, NE",Dawson County, NE,2011,13190,12531,659,5
31,49,"Deuel County, NE",Deuel County, NE,2011,1068,1031,37,3.5
31,51,"Dixon County, NE",Dixon County, NE,2011,3161,3017,144,4.6
31,53,"Dodge County, NE",Dodge County, NE,2011,19131,18190,941,4.9
31,55,"Douglas County, NE",Douglas County, NE,2011,282043,268236,13807,4.9
31,57,"Dundy County, NE",Dundy County, NE,2011,1275,1238,37,2.9
31,59,"Fillmore County, NE",Fillmore County, NE,2011,3324,3209,115,3.5
31,61,"Franklin County, NE",Franklin County, NE,2011,1671,1601,70,4.2
31,63,"Frontier County, NE",Frontier County, NE,2011,1602,1545,57,3.6
31,65,"Furnas County, NE",Furnas County, NE,2011,2712,2613,99,3.7
31,67,"Gage County, NE",Gage County, NE,2011,11191,10544,647,5.8
31,69,"Garden County, NE",Garden County, NE,2011,1260,1215,45,3.6
31,71,"Garfield County, NE",Garfield County, NE,2011,1206,1165,41,3.4
31,73,"Gosper County, NE",Gosper County, NE,2011,1130,1090,40,3.5
31,75,"Grant County, NE",Grant County, NE,2011,454,439,15,3.3
31,77,"Greeley County, NE",Greeley County, NE,2011,1361,1308,53,3.9
31,79,"Hall County, NE",Hall County, NE,2011,32013,30581,1432,4.5
31,81,"Hamilton County, NE",Hamilton County, NE,2011,4833,4650,183,3.8
31,83,"Harlan County, NE",Harlan County, NE,2011,1894,1832,62,3.3
31,85,"Hayes County, NE",Hayes County, NE,2011,679,658,21,3.1
31,87,"Hitchcock County, NE",Hitchcock County, NE,2011,1376,1309,67,4.9
31,89,"Holt County, NE",Holt County, NE,2011,5941,5737,204,3.4
31,91,"Hooker County, NE",Hooker County, NE,2011,447,426,21,4.7
31,93,"Howard County, NE",Howard County, NE,2011,3395,3257,138,4.1
31,95,"Jefferson County, NE",Jefferson County, NE,2011,4375,4186,189,4.3
31,97,"Johnson County, NE",Johnson County, NE,2011,2215,2108,107,4.8
31,99,"Kearney County, NE",Kearney County, NE,2011,3904,3778,126,3.2
31,101,"Keith County, NE",Keith County, NE,2011,4655,4465,190,4.1
31,103,"Keya Paha County, NE",Keya Paha County, NE,2011,602,584,18,3
31,105,"Kimball County, NE",Kimball County, NE,2011,2181,2102,79,3.6
31,107,"Knox County, NE",Knox County, NE,2011,4762,4577,185,3.9
31,109,"Lancaster County, NE",Lancaster County, NE,2011,164156,157591,6565,4
31,111,"Lincoln County, NE",Lincoln County, NE,2011,19422,18571,851,4.4
31,113,"Logan County, NE",Logan County, NE,2011,509,491,18,3.5
31,115,"Loup County, NE",Loup County, NE,2011,378,360,18,4.8
31,117,"McPherson County, NE",McPherson County, NE,2011,366,357,9,2.5
31,119,"Madison County, NE",Madison County, NE,2011,19091,18314,777,4.1
31,121,"Merrick County, NE",Merrick County, NE,2011,4174,3996,178,4.3
31,123,"Morrill County, NE",Morrill County, NE,2011,2658,2568,90,3.4
31,125,"Nance County, NE",Nance County, NE,2011,2063,1987,76,3.7
31,127,"Nemaha County, NE",Nemaha County, NE,2011,3961,3764,197,5
31,129,"Nuckolls County, NE",Nuckolls County, NE,2011,2496,2406,90,3.6
31,131,"Otoe County, NE",Otoe County, NE,2011,8555,8121,434,5.1
31,133,"Pawnee County, NE",Pawnee County, NE,2011,1653,1591,62,3.8
31,135,"Perkins County, NE",Perkins County, NE,2011,1803,1751,52,2.9
31,137,"Phelps County, NE",Phelps County, NE,2011,5013,4830,183,3.7
31,139,"Pierce County, NE",Pierce County, NE,2011,4212,4063,149,3.5
31,141,"Platte County, NE",Platte County, NE,2011,17825,17083,742,4.2
31,143,"Polk County, NE",Polk County, NE,2011,3000,2897,103,3.4
31,145,"Red Willow County, NE",Red Willow County, NE,2011,6287,6069,218,3.5
31,147,"Richardson County, NE",Richardson County, NE,2011,4405,4139,266,6
31,149,"Rock County, NE",Rock County, NE,2011,899,875,24,2.7
31,151,"Saline County, NE",Saline County, NE,2011,7344,6998,346,4.7
31,153,"Sarpy County, NE",Sarpy County, NE,2011,86350,82692,3658,4.2
31,155,"Saunders County, NE",Saunders County, NE,2011,11202,10688,514,4.6
31,157,"Scotts Bluff County, NE",Scotts Bluff County, NE,2011,19209,18245,964,5
31,159,"Seward County, NE",Seward County, NE,2011,8767,8430,337,3.8
31,161,"Sheridan County, NE",Sheridan County, NE,2011,2831,2730,101,3.6
31,163,"Sherman County, NE",Sherman County, NE,2011,1759,1683,76,4.3
31,165,"Sioux County, NE",Sioux County, NE,2011,844,815,29,3.4
31,167,"Stanton County, NE",Stanton County, NE,2011,3628,3493,135,3.7
31,169,"Thayer County, NE",Thayer County, NE,2011,2926,2830,96,3.3
31,171,"Thomas County, NE",Thomas County, NE,2011,426,404,22,5.2
31,173,"Thurston County, NE",Thurston County, NE,2011,3122,2804,318,10.2
31,175,"Valley County, NE",Valley County, NE,2011,2149,2063,86,4
31,177,"Washington County, NE",Washington County, NE,2011,11240,10751,489,4.4
31,179,"Wayne County, NE",Wayne County, NE,2011,5608,5414,194,3.5
31,181,"Webster County, NE",Webster County, NE,2011,1736,1656,80,4.6
31,183,"Wheeler County, NE",Wheeler County, NE,2011,524,507,17,3.2
31,185,"York County, NE",York County, NE,2011,7515,7189,326,4.3
32,1,"Churchill County, NV",Churchill County, NV,2011,11319,9915,1404,12.4
32,3,"Clark County, NV",Clark County, NV,2011,995119,863498,131621,13.2
32,5,"Douglas County, NV",Douglas County, NV,2011,23178,20109,3069,13.2
32,7,"Elko County, NV",Elko County, NV,2011,28174,26136,2038,7.2
32,9,"Esmeralda County, NV",Esmeralda County, NV,2011,416,383,33,7.9
32,11,"Eureka County, NV",Eureka County, NV,2011,1072,998,74,6.9
32,13,"Humboldt County, NV",Humboldt County, NV,2011,8738,8054,684,7.8
32,15,"Lander County, NV",Lander County, NV,2011,3219,2936,283,8.8
32,17,"Lincoln County, NV",Lincoln County, NV,2011,2069,1838,231,11.2
32,19,"Lyon County, NV",Lyon County, NV,2011,23013,19165,3848,16.7
32,21,"Mineral County, NV",Mineral County, NV,2011,2229,1917,312,14
32,23,"Nye County, NV",Nye County, NV,2011,16826,13997,2829,16.8
32,27,"Pershing County, NV",Pershing County, NV,2011,2471,2204,267,10.8
32,29,"Storey County, NV",Storey County, NV,2011,1974,1664,310,15.7
32,31,"Washoe County, NV",Washoe County, NV,2011,221688,193787,27901,12.6
32,33,"White Pine County, NV",White Pine County, NV,2011,5099,4656,443,8.7
32,510,"Carson City, NV",Carson City, NV,2011,26513,23008,3505,13.2
33,1,"Belknap County, NH",Belknap County, NH,2011,32054,30289,1765,5.5
33,3,"Carroll County, NH",Carroll County, NH,2011,24773,23414,1359,5.5
33,5,"Cheshire County, NH",Cheshire County, NH,2011,42593,40419,2174,5.1
33,7,"Coos County, NH",Coos County, NH,2011,16351,15166,1185,7.2
33,9,"Grafton County, NH",Grafton County, NH,2011,48730,46519,2211,4.5
33,11,"Hillsborough County, NH",Hillsborough County, NH,2011,225059,212357,12702,5.6
33,13,"Merrimack County, NH",Merrimack County, NH,2011,81049,77088,3961,4.9
33,15,"Rockingham County, NH",Rockingham County, NH,2011,172161,162510,9651,5.6
33,17,"Strafford County, NH",Strafford County, NH,2011,69601,65916,3685,5.3
33,19,"Sullivan County, NH",Sullivan County, NH,2011,23933,22854,1079,4.5
34,1,"Atlantic County, NJ",Atlantic County, NJ,2011,139601,122129,17472,12.5
34,3,"Bergen County, NJ",Bergen County, NJ,2011,481293,444169,37124,7.7
34,5,"Burlington County, NJ",Burlington County, NJ,2011,235710,215180,20530,8.7
34,7,"Camden County, NJ",Camden County, NJ,2011,262849,234314,28535,10.9
34,9,"Cape May County, NJ",Cape May County, NJ,2011,49421,42071,7350,14.9
34,11,"Cumberland County, NJ",Cumberland County, NJ,2011,71589,62276,9313,13
34,13,"Essex County, NJ",Essex County, NJ,2011,383507,342059,41448,10.8
34,15,"Gloucester County, NJ",Gloucester County, NJ,2011,151925,136453,15472,10.2
34,17,"Hudson County, NJ",Hudson County, NJ,2011,357051,324353,32698,9.2
34,19,"Hunterdon County, NJ",Hunterdon County, NJ,2011,67838,63159,4679,6.9
34,21,"Mercer County, NJ",Mercer County, NJ,2011,193395,177378,16017,8.3
34,23,"Middlesex County, NJ",Middlesex County, NJ,2011,427070,389811,37259,8.7
34,25,"Monmouth County, NJ",Monmouth County, NJ,2011,330006,301735,28271,8.6
34,27,"Morris County, NJ",Morris County, NJ,2011,265885,247128,18757,7.1
34,29,"Ocean County, NJ",Ocean County, NJ,2011,266169,238461,27708,10.4
34,31,"Passaic County, NJ",Passaic County, NJ,2011,253452,225534,27918,11
34,33,"Salem County, NJ",Salem County, NJ,2011,32376,28604,3772,11.7
34,35,"Somerset County, NJ",Somerset County, NJ,2011,174610,161730,12880,7.4
34,37,"Sussex County, NJ",Sussex County, NJ,2011,81874,74313,7561,9.2
34,39,"Union County, NJ",Union County, NJ,2011,280947,254239,26708,9.5
34,41,"Warren County, NJ",Warren County, NJ,2011,58704,53370,5334,9.1
35,1,"Bernalillo County, NM",Bernalillo County, NM,2011,323936,300568,23368,7.2
35,3,"Catron County, NM",Catron County, NM,2011,1138,1009,129,11.3
35,5,"Chaves County, NM",Chaves County, NM,2011,27553,25685,1868,6.8
35,6,"Cibola County, NM",Cibola County, NM,2011,9179,8338,841,9.2
35,7,"Colfax County, NM",Colfax County, NM,2011,6349,5835,514,8.1
35,9,"Curry County, NM",Curry County, NM,2011,21546,20456,1090,5.1
35,11,"De Baca County, NM",De Baca County, NM,2011,814,774,40,4.9
35,13,"Dona Ana County, NM",Dona Ana County, NM,2011,93459,86421,7038,7.5
35,15,"Eddy County, NM",Eddy County, NM,2011,26493,25143,1350,5.1
35,17,"Grant County, NM",Grant County, NM,2011,12924,11994,930,7.2
35,19,"Guadalupe County, NM",Guadalupe County, NM,2011,1660,1483,177,10.7
35,21,"Harding County, NM",Harding County, NM,2011,296,277,19,6.4
35,23,"Hidalgo County, NM",Hidalgo County, NM,2011,2295,2123,172,7.5
35,25,"Lea County, NM",Lea County, NM,2011,27297,25774,1523,5.6
35,27,"Lincoln County, NM",Lincoln County, NM,2011,9085,8467,618,6.8
35,28,"Los Alamos County, NM",Los Alamos County, NM,2011,9257,8928,329,3.6
35,29,"Luna County, NM",Luna County, NM,2011,11505,9181,2324,20.2
35,31,"McKinley County, NM",McKinley County, NM,2011,24950,22477,2473,9.9
35,33,"Mora County, NM",Mora County, NM,2011,2369,2073,296,12.5
35,35,"Otero County, NM",Otero County, NM,2011,24754,23087,1667,6.7
35,37,"Quay County, NM",Quay County, NM,2011,3383,3058,325,9.6
35,39,"Rio Arriba County, NM",Rio Arriba County, NM,2011,17261,15663,1598,9.3
35,41,"Roosevelt County, NM",Roosevelt County, NM,2011,8318,7840,478,5.7
35,43,"Sandoval County, NM",Sandoval County, NM,2011,60842,55968,4874,8
35,45,"San Juan County, NM",San Juan County, NM,2011,55074,50751,4323,7.8
35,47,"San Miguel County, NM",San Miguel County, NM,2011,11044,9991,1053,9.5
35,49,"Santa Fe County, NM",Santa Fe County, NM,2011,73079,68495,4584,6.3
35,51,"Sierra County, NM",Sierra County, NM,2011,3864,3480,384,9.9
35,53,"Socorro County, NM",Socorro County, NM,2011,6842,6317,525,7.7
35,55,"Taos County, NM",Taos County, NM,2011,15282,13697,1585,10.4
35,57,"Torrance County, NM",Torrance County, NM,2011,5873,5205,668,11.4
35,59,"Union County, NM",Union County, NM,2011,1917,1825,92,4.8
35,61,"Valencia County, NM",Valencia County, NM,2011,30728,27926,2802,9.1
36,1,"Albany County, NY",Albany County, NY,2011,158289,147330,10959,6.9
36,3,"Allegany County, NY",Allegany County, NY,2011,23657,21545,2112,8.9
36,5,"Bronx County, NY",Bronx County, NY,2011,584353,514635,69718,11.9
36,7,"Broome County, NY",Broome County, NY,2011,94727,86579,8148,8.6
36,9,"Cattaraugus County, NY",Cattaraugus County, NY,2011,38540,34943,3597,9.3
36,11,"Cayuga County, NY",Cayuga County, NY,2011,39068,35899,3169,8.1
36,13,"Chautauqua County, NY",Chautauqua County, NY,2011,61661,56616,5045,8.2
36,15,"Chemung County, NY",Chemung County, NY,2011,40803,37606,3197,7.8
36,17,"Chenango County, NY",Chenango County, NY,2011,23830,21760,2070,8.7
36,19,"Clinton County, NY",Clinton County, NY,2011,38413,34729,3684,9.6
36,21,"Columbia County, NY",Columbia County, NY,2011,31452,29216,2236,7.1
36,23,"Cortland County, NY",Cortland County, NY,2011,24341,22284,2057,8.5
36,25,"Delaware County, NY",Delaware County, NY,2011,21717,19833,1884,8.7
36,27,"Dutchess County, NY",Dutchess County, NY,2011,146309,135325,10984,7.5
36,29,"Erie County, NY",Erie County, NY,2011,458769,422123,36646,8
36,31,"Essex County, NY",Essex County, NY,2011,18201,16546,1655,9.1
36,33,"Franklin County, NY",Franklin County, NY,2011,21725,19744,1981,9.1
36,35,"Fulton County, NY",Fulton County, NY,2011,25552,22854,2698,10.6
36,37,"Genesee County, NY",Genesee County, NY,2011,30922,28516,2406,7.8
36,39,"Greene County, NY",Greene County, NY,2011,21576,19552,2024,9.4
36,41,"Hamilton County, NY",Hamilton County, NY,2011,2442,2201,241,9.9
36,43,"Herkimer County, NY",Herkimer County, NY,2011,30723,28048,2675,8.7
36,45,"Jefferson County, NY",Jefferson County, NY,2011,48934,44154,4780,9.8
36,47,"Kings County, NY",Kings County, NY,2011,1170616,1058657,111959,9.6
36,49,"Lewis County, NY",Lewis County, NY,2011,12393,11197,1196,9.7
36,51,"Livingston County, NY",Livingston County, NY,2011,32007,29560,2447,7.6
36,53,"Madison County, NY",Madison County, NY,2011,34733,31896,2837,8.2
36,55,"Monroe County, NY",Monroe County, NY,2011,373786,345099,28687,7.7
36,57,"Montgomery County, NY",Montgomery County, NY,2011,23432,21034,2398,10.2
36,59,"Nassau County, NY",Nassau County, NY,2011,683283,636681,46602,6.8
36,61,"New York County, NY",New York County, NY,2011,882224,813275,68949,7.8
36,63,"Niagara County, NY",Niagara County, NY,2011,105602,95951,9651,9.1
36,65,"Oneida County, NY",Oneida County, NY,2011,108979,100271,8708,8
36,67,"Onondaga County, NY",Onondaga County, NY,2011,232622,214674,17948,7.7
36,69,"Ontario County, NY",Ontario County, NY,2011,55756,51805,3951,7.1
36,71,"Orange County, NY",Orange County, NY,2011,178868,165070,13798,7.7
36,73,"Orleans County, NY",Orleans County, NY,2011,18812,17075,1737,9.2
36,75,"Oswego County, NY",Oswego County, NY,2011,57994,51752,6242,10.8
36,77,"Otsego County, NY",Otsego County, NY,2011,31375,28950,2425,7.7
36,79,"Putnam County, NY",Putnam County, NY,2011,51607,47980,3627,7
36,81,"Queens County, NY",Queens County, NY,2011,1108920,1019249,89671,8.1
36,83,"Rensselaer County, NY",Rensselaer County, NY,2011,82767,76480,6287,7.6
36,85,"Richmond County, NY",Richmond County, NY,2011,216722,196872,19850,9.2
36,87,"Rockland County, NY",Rockland County, NY,2011,148873,138245,10628,7.1
36,89,"St. Lawrence County, NY",St. Lawrence County, NY,2011,48900,43824,5076,10.4
36,91,"Saratoga County, NY",Saratoga County, NY,2011,115669,107973,7696,6.7
36,93,"Schenectady County, NY",Schenectady County, NY,2011,77068,71293,5775,7.5
36,95,"Schoharie County, NY",Schoharie County, NY,2011,15557,14163,1394,9
36,97,"Schuyler County, NY",Schuyler County, NY,2011,9008,8212,796,8.8
36,99,"Seneca County, NY",Seneca County, NY,2011,16104,14829,1275,7.9
36,101,"Steuben County, NY",Steuben County, NY,2011,46123,41919,4204,9.1
36,103,"Suffolk County, NY",Suffolk County, NY,2011,770533,711930,58603,7.6
36,105,"Sullivan County, NY",Sullivan County, NY,2011,35480,32335,3145,8.9
36,107,"Tioga County, NY",Tioga County, NY,2011,25818,23832,1986,7.7
36,109,"Tompkins County, NY",Tompkins County, NY,2011,54190,50910,3280,6.1
36,111,"Ulster County, NY",Ulster County, NY,2011,91289,84123,7166,7.8
36,113,"Warren County, NY",Warren County, NY,2011,33619,30619,3000,8.9
36,115,"Washington County, NY",Washington County, NY,2011,29721,27318,2403,8.1
36,117,"Wayne County, NY",Wayne County, NY,2011,46445,42533,3912,8.4
36,119,"Westchester County, NY",Westchester County, NY,2011,473504,440021,33483,7.1
36,121,"Wyoming County, NY",Wyoming County, NY,2011,18881,17232,1649,8.7
36,123,"Yates County, NY",Yates County, NY,2011,12086,11181,905,7.5
37,1,"Alamance County, NC",Alamance County, NC,2011,77251,69789,7462,9.7
37,3,"Alexander County, NC",Alexander County, NC,2011,17890,15872,2018,11.3
37,5,"Alleghany County, NC",Alleghany County, NC,2011,4629,4063,566,12.2
37,7,"Anson County, NC",Anson County, NC,2011,11105,9741,1364,12.3
37,9,"Ashe County, NC",Ashe County, NC,2011,13247,11797,1450,10.9
37,11,"Avery County, NC",Avery County, NC,2011,7767,6905,862,11.1
37,13,"Beaufort County, NC",Beaufort County, NC,2011,21472,19084,2388,11.1
37,15,"Bertie County, NC",Bertie County, NC,2011,9069,7974,1095,12.1
37,17,"Bladen County, NC",Bladen County, NC,2011,14866,12874,1992,13.4
37,19,"Brunswick County, NC",Brunswick County, NC,2011,47007,41265,5742,12.2
37,21,"Buncombe County, NC",Buncombe County, NC,2011,124855,114955,9900,7.9
37,23,"Burke County, NC",Burke County, NC,2011,41188,36475,4713,11.4
37,25,"Cabarrus County, NC",Cabarrus County, NC,2011,89786,80444,9342,10.4
37,27,"Caldwell County, NC",Caldwell County, NC,2011,37336,32389,4947,13.2
37,29,"Camden County, NC",Camden County, NC,2011,4594,4201,393,8.6
37,31,"Carteret County, NC",Carteret County, NC,2011,30963,27957,3006,9.7
37,33,"Caswell County, NC",Caswell County, NC,2011,10111,8920,1191,11.8
37,35,"Catawba County, NC",Catawba County, NC,2011,76798,67838,8960,11.7
37,37,"Chatham County, NC",Chatham County, NC,2011,31114,28589,2525,8.1
37,39,"Cherokee County, NC",Cherokee County, NC,2011,11601,10228,1373,11.8
37,41,"Chowan County, NC",Chowan County, NC,2011,5959,5235,724,12.1
37,43,"Clay County, NC",Clay County, NC,2011,4146,3668,478,11.5
37,45,"Cleveland County, NC",Cleveland County, NC,2011,45870,40198,5672,12.4
37,47,"Columbus County, NC",Columbus County, NC,2011,23954,20749,3205,13.4
37,49,"Craven County, NC",Craven County, NC,2011,41917,37492,4425,10.6
37,51,"Cumberland County, NC",Cumberland County, NC,2011,132516,118580,13936,10.5
37,53,"Currituck County, NC",Currituck County, NC,2011,12348,11230,1118,9.1
37,55,"Dare County, NC",Dare County, NC,2011,20052,17442,2610,13
37,57,"Davidson County, NC",Davidson County, NC,2011,79392,70645,8747,11
37,59,"Davie County, NC",Davie County, NC,2011,19987,17872,2115,10.6
37,61,"Duplin County, NC",Duplin County, NC,2011,26232,23750,2482,9.5
37,63,"Durham County, NC",Durham County, NC,2011,145264,133506,11758,8.1
37,65,"Edgecombe County, NC",Edgecombe County, NC,2011,24921,21053,3868,15.5
37,67,"Forsyth County, NC",Forsyth County, NC,2011,173589,156527,17062,9.8
37,69,"Franklin County, NC",Franklin County, NC,2011,27936,24958,2978,10.7
37,71,"Gaston County, NC",Gaston County, NC,2011,100426,88510,11916,11.9
37,73,"Gates County, NC",Gates County, NC,2011,5425,4980,445,8.2
37,75,"Graham County, NC",Graham County, NC,2011,3618,2965,653,18
37,77,"Granville County, NC",Granville County, NC,2011,27862,25380,2482,8.9
37,79,"Greene County, NC",Greene County, NC,2011,9557,8639,918,9.6
37,81,"Guilford County, NC",Guilford County, NC,2011,253049,226595,26454,10.5
37,83,"Halifax County, NC",Halifax County, NC,2011,22371,19110,3261,14.6
37,85,"Harnett County, NC",Harnett County, NC,2011,49141,43555,5586,11.4
37,87,"Haywood County, NC",Haywood County, NC,2011,27553,24779,2774,10.1
37,89,"Henderson County, NC",Henderson County, NC,2011,48476,44365,4111,8.5
37,91,"Hertford County, NC",Hertford County, NC,2011,9632,8539,1093,11.3
37,93,"Hoke County, NC",Hoke County, NC,2011,19447,17331,2116,10.9
37,95,"Hyde County, NC",Hyde County, NC,2011,2113,1830,283,13.4
37,97,"Iredell County, NC",Iredell County, NC,2011,78493,69551,8942,11.4
37,99,"Jackson County, NC",Jackson County, NC,2011,18073,16062,2011,11.1
37,101,"Johnston County, NC",Johnston County, NC,2011,82441,74613,7828,9.5
37,103,"Jones County, NC",Jones County, NC,2011,4582,4095,487,10.6
37,105,"Lee County, NC",Lee County, NC,2011,27228,23874,3354,12.3
37,107,"Lenoir County, NC",Lenoir County, NC,2011,27598,24593,3005,10.9
37,109,"Lincoln County, NC",Lincoln County, NC,2011,39784,35334,4450,11.2
37,111,"McDowell County, NC",McDowell County, NC,2011,20621,18075,2546,12.3
37,113,"Macon County, NC",Macon County, NC,2011,15482,13728,1754,11.3
37,115,"Madison County, NC",Madison County, NC,2011,9450,8482,968,10.2
37,117,"Martin County, NC",Martin County, NC,2011,10638,9316,1322,12.4
37,119,"Mecklenburg County, NC",Mecklenburg County, NC,2011,513511,462559,50952,9.9
37,121,"Mitchell County, NC",Mitchell County, NC,2011,6747,5947,800,11.9
37,123,"Montgomery County, NC",Montgomery County, NC,2011,11519,10163,1356,11.8
37,125,"Moore County, NC",Moore County, NC,2011,37109,33570,3539,9.5
37,127,"Nash County, NC",Nash County, NC,2011,46912,41056,5856,12.5
37,129,"New Hanover County, NC",New Hanover County, NC,2011,107481,97210,10271,9.6
37,131,"Northampton County, NC",Northampton County, NC,2011,8640,7584,1056,12.2
37,133,"Onslow County, NC",Onslow County, NC,2011,62674,57481,5193,8.3
37,135,"Orange County, NC",Orange County, NC,2011,70159,65568,4591,6.5
37,137,"Pamlico County, NC",Pamlico County, NC,2011,5480,4947,533,9.7
37,139,"Pasquotank County, NC",Pasquotank County, NC,2011,18278,16392,1886,10.3
37,141,"Pender County, NC",Pender County, NC,2011,24617,21826,2791,11.3
37,143,"Perquimans County, NC",Perquimans County, NC,2011,5305,4723,582,11
37,145,"Person County, NC",Person County, NC,2011,18557,16344,2213,11.9
37,147,"Pitt County, NC",Pitt County, NC,2011,85761,77072,8689,10.1
37,149,"Polk County, NC",Polk County, NC,2011,8449,7662,787,9.3
37,151,"Randolph County, NC",Randolph County, NC,2011,68695,61178,7517,10.9
37,153,"Richmond County, NC",Richmond County, NC,2011,18531,15861,2670,14.4
37,155,"Robeson County, NC",Robeson County, NC,2011,53554,45944,7610,14.2
37,157,"Rockingham County, NC",Rockingham County, NC,2011,43559,38202,5357,12.3
37,159,"Rowan County, NC",Rowan County, NC,2011,63474,55567,7907,12.5
37,161,"Rutherford County, NC",Rutherford County, NC,2011,26504,22647,3857,14.6
37,163,"Sampson County, NC",Sampson County, NC,2011,29688,26788,2900,9.8
37,165,"Scotland County, NC",Scotland County, NC,2011,12875,10557,2318,18
37,167,"Stanly County, NC",Stanly County, NC,2011,28859,25466,3393,11.8
37,169,"Stokes County, NC",Stokes County, NC,2011,22503,20159,2344,10.4
37,171,"Surry County, NC",Surry County, NC,2011,33845,30191,3654,10.8
37,173,"Swain County, NC",Swain County, NC,2011,6485,5471,1014,15.6
37,175,"Transylvania County, NC",Transylvania County, NC,2011,13399,12136,1263,9.4
37,177,"Tyrrell County, NC",Tyrrell County, NC,2011,1633,1389,244,14.9
37,179,"Union County, NC",Union County, NC,2011,102354,93019,9335,9.1
37,181,"Vance County, NC",Vance County, NC,2011,18646,15867,2779,14.9
37,183,"Wake County, NC",Wake County, NC,2011,487757,449425,38332,7.9
37,185,"Warren County, NC",Warren County, NC,2011,7646,6579,1067,14
37,187,"Washington County, NC",Washington County, NC,2011,4993,4151,842,16.9
37,189,"Watauga County, NC",Watauga County, NC,2011,26998,24871,2127,7.9
37,191,"Wayne County, NC",Wayne County, NC,2011,54874,49913,4961,9
37,193,"Wilkes County, NC",Wilkes County, NC,2011,31091,27431,3660,11.8
37,195,"Wilson County, NC",Wilson County, NC,2011,38283,32960,5323,13.9
37,197,"Yadkin County, NC",Yadkin County, NC,2011,17960,16110,1850,10.3
37,199,"Yancey County, NC",Yancey County, NC,2011,7895,7002,893,11.3
38,1,"Adams County, ND",Adams County, ND,2011,1165,1132,33,2.8
38,3,"Barnes County, ND",Barnes County, ND,2011,6046,5808,238,3.9
38,5,"Benson County, ND",Benson County, ND,2011,2930,2753,177,6
38,7,"Billings County, ND",Billings County, ND,2011,440,423,17,3.9
38,9,"Bottineau County, ND",Bottineau County, ND,2011,3436,3307,129,3.8
38,11,"Bowman County, ND",Bowman County, ND,2011,1876,1835,41,2.2
38,13,"Burke County, ND",Burke County, ND,2011,1235,1206,29,2.3
38,15,"Burleigh County, ND",Burleigh County, ND,2011,46730,45210,1520,3.3
38,17,"Cass County, ND",Cass County, ND,2011,89620,86697,2923,3.3
38,19,"Cavalier County, ND",Cavalier County, ND,2011,2249,2181,68,3
38,21,"Dickey County, ND",Dickey County, ND,2011,2823,2741,82,2.9
38,23,"Divide County, ND",Divide County, ND,2011,1579,1551,28,1.8
38,25,"Dunn County, ND",Dunn County, ND,2011,2929,2868,61,2.1
38,27,"Eddy County, ND",Eddy County, ND,2011,1273,1210,63,4.9
38,29,"Emmons County, ND",Emmons County, ND,2011,1771,1664,107,6
38,31,"Foster County, ND",Foster County, ND,2011,1766,1710,56,3.2
38,33,"Golden Valley County, ND",Golden Valley County, ND,2011,980,956,24,2.4
38,35,"Grand Forks County, ND",Grand Forks County, ND,2011,37731,36342,1389,3.7
38,37,"Grant County, ND",Grant County, ND,2011,1392,1343,49,3.5
38,39,"Griggs County, ND",Griggs County, ND,2011,1267,1229,38,3
38,41,"Hettinger County, ND",Hettinger County, ND,2011,1489,1446,43,2.9
38,43,"Kidder County, ND",Kidder County, ND,2011,1357,1286,71,5.2
38,45,"LaMoure County, ND",LaMoure County, ND,2011,2398,2326,72,3
38,47,"Logan County, ND",Logan County, ND,2011,978,948,30,3.1
38,49,"McHenry County, ND",McHenry County, ND,2011,3326,3172,154,4.6
38,51,"McIntosh County, ND",McIntosh County, ND,2011,1309,1260,49,3.7
38,53,"McKenzie County, ND",McKenzie County, ND,2011,4620,4537,83,1.8
38,55,"McLean County, ND",McLean County, ND,2011,4982,4746,236,4.7
38,57,"Mercer County, ND",Mercer County, ND,2011,4142,3918,224,5.4
38,59,"Morton County, ND",Morton County, ND,2011,15833,15197,636,4
38,61,"Mountrail County, ND",Mountrail County, ND,2011,6500,6360,140,2.2
38,63,"Nelson County, ND",Nelson County, ND,2011,1664,1592,72,4.3
38,65,"Oliver County, ND",Oliver County, ND,2011,925,868,57,6.2
38,67,"Pembina County, ND",Pembina County, ND,2011,3929,3658,271,6.9
38,69,"Pierce County, ND",Pierce County, ND,2011,1936,1843,93,4.8
38,71,"Ramsey County, ND",Ramsey County, ND,2011,6073,5841,232,3.8
38,73,"Ransom County, ND",Ransom County, ND,2011,2879,2777,102,3.5
38,75,"Renville County, ND",Renville County, ND,2011,1446,1406,40,2.8
38,77,"Richland County, ND",Richland County, ND,2011,8883,8544,339,3.8
38,79,"Rolette County, ND",Rolette County, ND,2011,5154,4590,564,10.9
38,81,"Sargent County, ND",Sargent County, ND,2011,2111,2046,65,3.1
38,83,"Sheridan County, ND",Sheridan County, ND,2011,799,767,32,4
38,85,"Sioux County, ND",Sioux County, ND,2011,1330,1258,72,5.4
38,87,"Slope County, ND",Slope County, ND,2011,493,483,10,2
38,89,"Stark County, ND",Stark County, ND,2011,16072,15719,353,2.2
38,91,"Steele County, ND",Steele County, ND,2011,1114,1085,29,2.6
38,93,"Stutsman County, ND",Stutsman County, ND,2011,10840,10428,412,3.8
38,95,"Towner County, ND",Towner County, ND,2011,1350,1309,41,3
38,97,"Traill County, ND",Traill County, ND,2011,4606,4438,168,3.6
38,99,"Walsh County, ND",Walsh County, ND,2011,5968,5668,300,5
38,101,"Ward County, ND",Ward County, ND,2011,32491,31454,1037,3.2
38,103,"Wells County, ND",Wells County, ND,2011,2311,2210,101,4.4
38,105,"Williams County, ND",Williams County, ND,2011,20091,19807,284,1.4
39,1,"Adams County, OH",Adams County, OH,2011,11524,9871,1653,14.3
39,3,"Allen County, OH",Allen County, OH,2011,50958,46106,4852,9.5
39,5,"Ashland County, OH",Ashland County, OH,2011,26144,23560,2584,9.9
39,7,"Ashtabula County, OH",Ashtabula County, OH,2011,47581,42405,5176,10.9
39,9,"Athens County, OH",Athens County, OH,2011,27851,25090,2761,9.9
39,11,"Auglaize County, OH",Auglaize County, OH,2011,24128,22175,1953,8.1
39,13,"Belmont County, OH",Belmont County, OH,2011,32286,29203,3083,9.5
39,15,"Brown County, OH",Brown County, OH,2011,20658,18210,2448,11.9
39,17,"Butler County, OH",Butler County, OH,2011,188924,171787,17137,9.1
39,19,"Carroll County, OH",Carroll County, OH,2011,14111,12672,1439,10.2
39,21,"Champaign County, OH",Champaign County, OH,2011,19527,17682,1845,9.4
39,23,"Clark County, OH",Clark County, OH,2011,67537,61130,6407,9.5
39,25,"Clermont County, OH",Clermont County, OH,2011,103615,94143,9472,9.1
39,27,"Clinton County, OH",Clinton County, OH,2011,18047,15611,2436,13.5
39,29,"Columbiana County, OH",Columbiana County, OH,2011,51859,46595,5264,10.2
39,31,"Coshocton County, OH",Coshocton County, OH,2011,16799,14872,1927,11.5
39,33,"Crawford County, OH",Crawford County, OH,2011,20800,18400,2400,11.5
39,35,"Cuyahoga County, OH",Cuyahoga County, OH,2011,623251,576023,47228,7.6
39,37,"Darke County, OH",Darke County, OH,2011,26655,24188,2467,9.3
39,39,"Defiance County, OH",Defiance County, OH,2011,19246,17389,1857,9.6
39,41,"Delaware County, OH",Delaware County, OH,2011,95206,89265,5941,6.2
39,43,"Erie County, OH",Erie County, OH,2011,39811,36025,3786,9.5
39,45,"Fairfield County, OH",Fairfield County, OH,2011,73970,68017,5953,8
39,47,"Fayette County, OH",Fayette County, OH,2011,14367,12857,1510,10.5
39,49,"Franklin County, OH",Franklin County, OH,2011,627448,578794,48654,7.8
39,51,"Fulton County, OH",Fulton County, OH,2011,22636,20456,2180,9.6
39,53,"Gallia County, OH",Gallia County, OH,2011,13034,11573,1461,11.2
39,55,"Geauga County, OH",Geauga County, OH,2011,48654,45721,2933,6
39,57,"Greene County, OH",Greene County, OH,2011,81800,75046,6754,8.3
39,59,"Guernsey County, OH",Guernsey County, OH,2011,18474,16475,1999,10.8
39,61,"Hamilton County, OH",Hamilton County, OH,2011,407539,371426,36113,8.9
39,63,"Hancock County, OH",Hancock County, OH,2011,40075,36960,3115,7.8
39,65,"Hardin County, OH",Hardin County, OH,2011,15104,13663,1441,9.5
39,67,"Harrison County, OH",Harrison County, OH,2011,7026,6277,749,10.7
39,69,"Henry County, OH",Henry County, OH,2011,14399,12856,1543,10.7
39,71,"Highland County, OH",Highland County, OH,2011,18111,15675,2436,13.5
39,73,"Hocking County, OH",Hocking County, OH,2011,13803,12430,1373,9.9
39,75,"Holmes County, OH",Holmes County, OH,2011,19592,18355,1237,6.3
39,77,"Huron County, OH",Huron County, OH,2011,29709,26329,3380,11.4
39,79,"Jackson County, OH",Jackson County, OH,2011,13966,12312,1654,11.8
39,81,"Jefferson County, OH",Jefferson County, OH,2011,32004,28157,3847,12
39,83,"Knox County, OH",Knox County, OH,2011,30505,27841,2664,8.7
39,85,"Lake County, OH",Lake County, OH,2011,125191,116647,8544,6.8
39,87,"Lawrence County, OH",Lawrence County, OH,2011,27088,24518,2570,9.5
39,89,"Licking County, OH",Licking County, OH,2011,86838,79550,7288,8.4
39,91,"Logan County, OH",Logan County, OH,2011,22851,20621,2230,9.8
39,93,"Lorain County, OH",Lorain County, OH,2011,149725,137981,11744,7.8
39,95,"Lucas County, OH",Lucas County, OH,2011,213380,192278,21102,9.9
39,97,"Madison County, OH",Madison County, OH,2011,20331,18723,1608,7.9
39,99,"Mahoning County, OH",Mahoning County, OH,2011,112957,101863,11094,9.8
39,101,"Marion County, OH",Marion County, OH,2011,29582,26662,2920,9.9
39,103,"Medina County, OH",Medina County, OH,2011,93801,87823,5978,6.4
39,105,"Meigs County, OH",Meigs County, OH,2011,9814,8524,1290,13.1
39,107,"Mercer County, OH",Mercer County, OH,2011,22180,20683,1497,6.7
39,109,"Miami County, OH",Miami County, OH,2011,53466,48585,4881,9.1
39,111,"Monroe County, OH",Monroe County, OH,2011,6600,5949,651,9.9
39,113,"Montgomery County, OH",Montgomery County, OH,2011,260110,234828,25282,9.7
39,115,"Morgan County, OH",Morgan County, OH,2011,6788,6016,772,11.4
39,117,"Morrow County, OH",Morrow County, OH,2011,17138,15402,1736,10.1
39,119,"Muskingum County, OH",Muskingum County, OH,2011,41313,36810,4503,10.9
39,121,"Noble County, OH",Noble County, OH,2011,4989,4323,666,13.3
39,123,"Ottawa County, OH",Ottawa County, OH,2011,22475,19987,2488,11.1
39,125,"Paulding County, OH",Paulding County, OH,2011,9458,8535,923,9.8
39,127,"Perry County, OH",Perry County, OH,2011,16427,14524,1903,11.6
39,129,"Pickaway County, OH",Pickaway County, OH,2011,25885,23505,2380,9.2
39,131,"Pike County, OH",Pike County, OH,2011,11035,9357,1678,15.2
39,133,"Portage County, OH",Portage County, OH,2011,89382,81464,7918,8.9
39,135,"Preble County, OH",Preble County, OH,2011,21728,19648,2080,9.6
39,137,"Putnam County, OH",Putnam County, OH,2011,19252,17820,1432,7.4
39,139,"Richland County, OH",Richland County, OH,2011,58139,51964,6175,10.6
39,141,"Ross County, OH",Ross County, OH,2011,34318,30901,3417,10
39,143,"Sandusky County, OH",Sandusky County, OH,2011,32721,29723,2998,9.2
39,145,"Scioto County, OH",Scioto County, OH,2011,31833,27843,3990,12.5
39,147,"Seneca County, OH",Seneca County, OH,2011,28806,26029,2777,9.6
39,149,"Shelby County, OH",Shelby County, OH,2011,24239,21895,2344,9.7
39,151,"Stark County, OH",Stark County, OH,2011,189210,171558,17652,9.3
39,153,"Summit County, OH",Summit County, OH,2011,276591,251471,25120,9.1
39,155,"Trumbull County, OH",Trumbull County, OH,2011,97442,87035,10407,10.7
39,157,"Tuscarawas County, OH",Tuscarawas County, OH,2011,45405,41189,4216,9.3
39,159,"Union County, OH",Union County, OH,2011,26723,24807,1916,7.2
39,161,"Van Wert County, OH",Van Wert County, OH,2011,14541,13189,1352,9.3
39,163,"Vinton County, OH",Vinton County, OH,2011,5733,5050,683,11.9
39,165,"Warren County, OH",Warren County, OH,2011,109603,100969,8634,7.9
39,167,"Washington County, OH",Washington County, OH,2011,29041,26123,2918,10
39,169,"Wayne County, OH",Wayne County, OH,2011,59186,54654,4532,7.7
39,171,"Williams County, OH",Williams County, OH,2011,18932,16895,2037,10.8
39,173,"Wood County, OH",Wood County, OH,2011,68376,62697,5679,8.3
39,175,"Wyandot County, OH",Wyandot County, OH,2011,12120,11002,1118,9.2
40,1,"Adair County, OK",Adair County, OK,2011,8849,8039,810,9.2
40,3,"Alfalfa County, OK",Alfalfa County, OK,2011,2558,2453,105,4.1
40,5,"Atoka County, OK",Atoka County, OK,2011,5013,4585,428,8.5
40,7,"Beaver County, OK",Beaver County, OK,2011,2952,2845,107,3.6
40,9,"Beckham County, OK",Beckham County, OK,2011,11336,10918,418,3.7
40,11,"Blaine County, OK",Blaine County, OK,2011,4355,4123,232,5.3
40,13,"Bryan County, OK",Bryan County, OK,2011,17508,16471,1037,5.9
40,15,"Caddo County, OK",Caddo County, OK,2011,11619,10795,824,7.1
40,17,"Canadian County, OK",Canadian County, OK,2011,61519,58827,2692,4.4
40,19,"Carter County, OK",Carter County, OK,2011,21652,20264,1388,6.4
40,21,"Cherokee County, OK",Cherokee County, OK,2011,19236,17835,1401,7.3
40,23,"Choctaw County, OK",Choctaw County, OK,2011,6028,5486,542,9
40,25,"Cimarron County, OK",Cimarron County, OK,2011,1371,1325,46,3.4
40,27,"Cleveland County, OK",Cleveland County, OK,2011,133181,127129,6052,4.5
40,29,"Coal County, OK",Coal County, OK,2011,2352,2154,198,8.4
40,31,"Comanche County, OK",Comanche County, OK,2011,50693,47787,2906,5.7
40,33,"Cotton County, OK",Cotton County, OK,2011,2915,2738,177,6.1
40,35,"Craig County, OK",Craig County, OK,2011,6347,5947,400,6.3
40,37,"Creek County, OK",Creek County, OK,2011,31308,29105,2203,7
40,39,"Custer County, OK",Custer County, OK,2011,15181,14571,610,4
40,41,"Delaware County, OK",Delaware County, OK,2011,17318,16080,1238,7.1
40,43,"Dewey County, OK",Dewey County, OK,2011,2470,2374,96,3.9
40,45,"Ellis County, OK",Ellis County, OK,2011,2113,2033,80,3.8
40,47,"Garfield County, OK",Garfield County, OK,2011,28821,27546,1275,4.4
40,49,"Garvin County, OK",Garvin County, OK,2011,12203,11494,709,5.8
40,51,"Grady County, OK",Grady County, OK,2011,25282,23942,1340,5.3
40,53,"Grant County, OK",Grant County, OK,2011,2545,2450,95,3.7
40,55,"Greer County, OK",Greer County, OK,2011,2144,2008,136,6.3
40,57,"Harmon County, OK",Harmon County, OK,2011,1319,1248,71,5.4
40,59,"Harper County, OK",Harper County, OK,2011,1869,1800,69,3.7
40,61,"Haskell County, OK",Haskell County, OK,2011,4677,4262,415,8.9
40,63,"Hughes County, OK",Hughes County, OK,2011,5474,4962,512,9.4
40,65,"Jackson County, OK",Jackson County, OK,2011,11348,10727,621,5.5
40,67,"Jefferson County, OK",Jefferson County, OK,2011,2660,2497,163,6.1
40,69,"Johnston County, OK",Johnston County, OK,2011,3713,3397,316,8.5
40,71,"Kay County, OK",Kay County, OK,2011,20647,19042,1605,7.8
40,73,"Kingfisher County, OK",Kingfisher County, OK,2011,7580,7286,294,3.9
40,75,"Kiowa County, OK",Kiowa County, OK,2011,4268,4048,220,5.2
40,77,"Latimer County, OK",Latimer County, OK,2011,4436,3995,441,9.9
40,79,"Le Flore County, OK",Le Flore County, OK,2011,20136,18340,1796,8.9
40,81,"Lincoln County, OK",Lincoln County, OK,2011,15504,14658,846,5.5
40,83,"Logan County, OK",Logan County, OK,2011,20211,19228,983,4.9
40,85,"Love County, OK",Love County, OK,2011,4915,4668,247,5
40,87,"McClain County, OK",McClain County, OK,2011,17256,16442,814,4.7
40,89,"McCurtain County, OK",McCurtain County, OK,2011,14754,13246,1508,10.2
40,91,"McIntosh County, OK",McIntosh County, OK,2011,7394,6611,783,10.6
40,93,"Major County, OK",Major County, OK,2011,4051,3889,162,4
40,95,"Marshall County, OK",Marshall County, OK,2011,6687,6285,402,6
40,97,"Mayes County, OK",Mayes County, OK,2011,18145,16768,1377,7.6
40,99,"Murray County, OK",Murray County, OK,2011,6484,6165,319,4.9
40,101,"Muskogee County, OK",Muskogee County, OK,2011,29891,27680,2211,7.4
40,103,"Noble County, OK",Noble County, OK,2011,5340,5066,274,5.1
40,105,"Nowata County, OK",Nowata County, OK,2011,4910,4518,392,8
40,107,"Okfuskee County, OK",Okfuskee County, OK,2011,4420,4042,378,8.6
40,109,"Oklahoma County, OK",Oklahoma County, OK,2011,357336,338450,18886,5.3
40,111,"Okmulgee County, OK",Okmulgee County, OK,2011,16537,15045,1492,9
40,113,"Osage County, OK",Osage County, OK,2011,21263,19824,1439,6.8
40,115,"Ottawa County, OK",Ottawa County, OK,2011,14313,13234,1079,7.5
40,117,"Pawnee County, OK",Pawnee County, OK,2011,7606,7010,596,7.8
40,119,"Payne County, OK",Payne County, OK,2011,36823,34988,1835,5
40,121,"Pittsburg County, OK",Pittsburg County, OK,2011,19051,17653,1398,7.3
40,123,"Pontotoc County, OK",Pontotoc County, OK,2011,18124,17141,983,5.4
40,125,"Pottawatomie County, OK",Pottawatomie County, OK,2011,31369,29492,1877,6
40,127,"Pushmataha County, OK",Pushmataha County, OK,2011,4952,4523,429,8.7
40,129,"Roger Mills County, OK",Roger Mills County, OK,2011,1902,1841,61,3.2
40,131,"Rogers County, OK",Rogers County, OK,2011,43070,40594,2476,5.7
40,133,"Seminole County, OK",Seminole County, OK,2011,9974,9144,830,8.3
40,135,"Sequoyah County, OK",Sequoyah County, OK,2011,17481,15871,1610,9.2
40,137,"Stephens County, OK",Stephens County, OK,2011,20405,19214,1191,5.8
40,139,"Texas County, OK",Texas County, OK,2011,8837,8448,389,4.4
40,141,"Tillman County, OK",Tillman County, OK,2011,3356,3160,196,5.8
40,143,"Tulsa County, OK",Tulsa County, OK,2011,304059,285655,18404,6.1
40,145,"Wagoner County, OK",Wagoner County, OK,2011,35134,33069,2065,5.9
40,147,"Washington County, OK",Washington County, OK,2011,24203,22815,1388,5.7
40,149,"Washita County, OK",Washita County, OK,2011,5511,5264,247,4.5
40,151,"Woods County, OK",Woods County, OK,2011,4490,4336,154,3.4
40,153,"Woodward County, OK",Woodward County, OK,2011,9919,9457,462,4.7
41,1,"Baker County, OR",Baker County, OR,2011,7317,6523,794,10.9
41,3,"Benton County, OR",Benton County, OR,2011,45957,43019,2938,6.4
41,5,"Clackamas County, OR",Clackamas County, OR,2011,204119,186047,18072,8.9
41,7,"Clatsop County, OR",Clatsop County, OR,2011,19036,17243,1793,9.4
41,9,"Columbia County, OR",Columbia County, OR,2011,23569,20906,2663,11.3
41,11,"Coos County, OR",Coos County, OR,2011,27968,24726,3242,11.6
41,13,"Crook County, OR",Crook County, OR,2011,9451,8101,1350,14.3
41,15,"Curry County, OR",Curry County, OR,2011,9213,8105,1108,12
41,17,"Deschutes County, OR",Deschutes County, OR,2011,80559,70657,9902,12.3
41,19,"Douglas County, OR",Douglas County, OR,2011,47485,41453,6032,12.7
41,21,"Gilliam County, OR",Gilliam County, OR,2011,973,879,94,9.7
41,23,"Grant County, OR",Grant County, OR,2011,3422,2950,472,13.8
41,25,"Harney County, OR",Harney County, OR,2011,3727,3231,496,13.3
41,27,"Hood River County, OR",Hood River County, OR,2011,14329,13195,1134,7.9
41,29,"Jackson County, OR",Jackson County, OR,2011,100467,88693,11774,11.7
41,31,"Jefferson County, OR",Jefferson County, OR,2011,9598,8375,1223,12.7
41,33,"Josephine County, OR",Josephine County, OR,2011,34489,30133,4356,12.6
41,35,"Klamath County, OR",Klamath County, OR,2011,31289,27533,3756,12
41,37,"Lake County, OR",Lake County, OR,2011,3753,3261,492,13.1
41,39,"Lane County, OR",Lane County, OR,2011,177473,160315,17158,9.7
41,41,"Lincoln County, OR",Lincoln County, OR,2011,21942,19651,2291,10.4
41,43,"Linn County, OR",Linn County, OR,2011,56637,50197,6440,11.4
41,45,"Malheur County, OR",Malheur County, OR,2011,13373,12111,1262,9.4
41,47,"Marion County, OR",Marion County, OR,2011,154593,138379,16214,10.5
41,49,"Morrow County, OR",Morrow County, OR,2011,5792,5316,476,8.2
41,51,"Multnomah County, OR",Multnomah County, OR,2011,424717,389294,35423,8.3
41,53,"Polk County, OR",Polk County, OR,2011,36294,32929,3365,9.3
41,55,"Sherman County, OR",Sherman County, OR,2011,920,818,102,11.1
41,57,"Tillamook County, OR",Tillamook County, OR,2011,11647,10493,1154,9.9
41,59,"Umatilla County, OR",Umatilla County, OR,2011,37378,33818,3560,9.5
41,61,"Union County, OR",Union County, OR,2011,12458,11216,1242,10
41,63,"Wallowa County, OR",Wallowa County, OR,2011,3487,3061,426,12.2
41,65,"Wasco County, OR",Wasco County, OR,2011,13905,12681,1224,8.8
41,67,"Washington County, OR",Washington County, OR,2011,294384,271644,22740,7.7
41,69,"Wheeler County, OR",Wheeler County, OR,2011,767,702,65,8.5
41,71,"Yamhill County, OR",Yamhill County, OR,2011,51404,46668,4736,9.2
42,1,"Adams County, PA",Adams County, PA,2011,54082,50470,3612,6.7
42,3,"Allegheny County, PA",Allegheny County, PA,2011,643067,597413,45654,7.1
42,5,"Armstrong County, PA",Armstrong County, PA,2011,33634,30874,2760,8.2
42,7,"Beaver County, PA",Beaver County, PA,2011,85919,79208,6711,7.8
42,9,"Bedford County, PA",Bedford County, PA,2011,24973,22704,2269,9.1
42,11,"Berks County, PA",Berks County, PA,2011,210152,193579,16573,7.9
42,13,"Blair County, PA",Blair County, PA,2011,61521,57038,4483,7.3
42,15,"Bradford County, PA",Bradford County, PA,2011,32014,29941,2073,6.5
42,17,"Bucks County, PA",Bucks County, PA,2011,336329,311767,24562,7.3
42,19,"Butler County, PA",Butler County, PA,2011,96645,90200,6445,6.7
42,21,"Cambria County, PA",Cambria County, PA,2011,66182,60426,5756,8.7
42,23,"Cameron County, PA",Cameron County, PA,2011,2510,2242,268,10.7
42,25,"Carbon County, PA",Carbon County, PA,2011,31886,28683,3203,10
42,27,"Centre County, PA",Centre County, PA,2011,77395,73194,4201,5.4
42,29,"Chester County, PA",Chester County, PA,2011,270039,254448,15591,5.8
42,31,"Clarion County, PA",Clarion County, PA,2011,19103,17207,1896,9.9
42,33,"Clearfield County, PA",Clearfield County, PA,2011,38040,34473,3567,9.4
42,35,"Clinton County, PA",Clinton County, PA,2011,19180,17575,1605,8.4
42,37,"Columbia County, PA",Columbia County, PA,2011,34779,31772,3007,8.6
42,39,"Crawford County, PA",Crawford County, PA,2011,41530,38206,3324,8
42,41,"Cumberland County, PA",Cumberland County, PA,2011,124435,116521,7914,6.4
42,43,"Dauphin County, PA",Dauphin County, PA,2011,140461,129830,10631,7.6
42,45,"Delaware County, PA",Delaware County, PA,2011,286894,264643,22251,7.8
42,47,"Elk County, PA",Elk County, PA,2011,16866,15620,1246,7.4
42,49,"Erie County, PA",Erie County, PA,2011,137280,126093,11187,8.1
42,51,"Fayette County, PA",Fayette County, PA,2011,59672,53674,5998,10.1
42,53,"Forest County, PA",Forest County, PA,2011,2034,1842,192,9.4
42,55,"Franklin County, PA",Franklin County, PA,2011,75525,69994,5531,7.3
42,57,"Fulton County, PA",Fulton County, PA,2011,7352,6609,743,10.1
42,59,"Greene County, PA",Greene County, PA,2011,18191,16802,1389,7.6
42,61,"Huntingdon County, PA",Huntingdon County, PA,2011,21005,18885,2120,10.1
42,63,"Indiana County, PA",Indiana County, PA,2011,44023,40569,3454,7.8
42,65,"Jefferson County, PA",Jefferson County, PA,2011,21791,19889,1902,8.7
42,67,"Juniata County, PA",Juniata County, PA,2011,12009,11125,884,7.4
42,69,"Lackawanna County, PA",Lackawanna County, PA,2011,107271,97811,9460,8.8
42,71,"Lancaster County, PA",Lancaster County, PA,2011,265990,247720,18270,6.9
42,73,"Lawrence County, PA",Lawrence County, PA,2011,43049,39433,3616,8.4
42,75,"Lebanon County, PA",Lebanon County, PA,2011,69834,65001,4833,6.9
42,77,"Lehigh County, PA",Lehigh County, PA,2011,179537,164016,15521,8.6
42,79,"Luzerne County, PA",Luzerne County, PA,2011,159839,144496,15343,9.6
42,81,"Lycoming County, PA",Lycoming County, PA,2011,61089,56362,4727,7.7
42,83,"McKean County, PA",McKean County, PA,2011,20112,18356,1756,8.7
42,85,"Mercer County, PA",Mercer County, PA,2011,53348,49142,4206,7.9
42,87,"Mifflin County, PA",Mifflin County, PA,2011,20997,19128,1869,8.9
42,89,"Monroe County, PA",Monroe County, PA,2011,82231,74253,7978,9.7
42,91,"Montgomery County, PA",Montgomery County, PA,2011,430355,402403,27952,6.5
42,93,"Montour County, PA",Montour County, PA,2011,9189,8615,574,6.2
42,95,"Northampton County, PA",Northampton County, PA,2011,152679,140092,12587,8.2
42,97,"Northumberland County, PA",Northumberland County, PA,2011,44954,40832,4122,9.2
42,99,"Perry County, PA",Perry County, PA,2011,24722,22895,1827,7.4
42,101,"Philadelphia County/city, PA",Philadelphia County/city, PA,2011,690905,617187,73718,10.7
42,103,"Pike County, PA",Pike County, PA,2011,26139,23555,2584,9.9
42,105,"Potter County, PA",Potter County, PA,2011,7834,7117,717,9.2
42,107,"Schuylkill County, PA",Schuylkill County, PA,2011,70051,63218,6833,9.8
42,109,"Snyder County, PA",Snyder County, PA,2011,19812,18287,1525,7.7
42,111,"Somerset County, PA",Somerset County, PA,2011,36948,33652,3296,8.9
42,113,"Sullivan County, PA",Sullivan County, PA,2011,3038,2817,221,7.3
42,115,"Susquehanna County, PA",Susquehanna County, PA,2011,21926,20184,1742,7.9
42,117,"Tioga County, PA",Tioga County, PA,2011,21193,19711,1482,7
42,119,"Union County, PA",Union County, PA,2011,19062,17774,1288,6.8
42,121,"Venango County, PA",Venango County, PA,2011,26397,24447,1950,7.4
42,123,"Warren County, PA",Warren County, PA,2011,20445,18910,1535,7.5
42,125,"Washington County, PA",Washington County, PA,2011,105887,98104,7783,7.4
42,127,"Wayne County, PA",Wayne County, PA,2011,23282,21394,1888,8.1
42,129,"Westmoreland County, PA",Westmoreland County, PA,2011,185889,171887,14002,7.5
42,131,"Wyoming County, PA",Wyoming County, PA,2011,14329,13069,1260,8.8
42,133,"York County, PA",York County, PA,2011,230655,213362,17293,7.5
44,1,"Bristol County, RI",Bristol County, RI,2011,26277,23823,2454,9.3
44,3,"Kent County, RI",Kent County, RI,2011,92769,82798,9971,10.7
44,5,"Newport County, RI",Newport County, RI,2011,44405,40091,4314,9.7
44,7,"Providence County, RI",Providence County, RI,2011,326155,288053,38102,11.7
44,9,"Washington County, RI",Washington County, RI,2011,70450,63483,6967,9.9
45,1,"Abbeville County, SC",Abbeville County, SC,2011,10780,9437,1343,12.5
45,3,"Aiken County, SC",Aiken County, SC,2011,73305,66506,6799,9.3
45,5,"Allendale County, SC",Allendale County, SC,2011,3279,2677,602,18.4
45,7,"Anderson County, SC",Anderson County, SC,2011,85902,77039,8863,10.3
45,9,"Bamberg County, SC",Bamberg County, SC,2011,6316,5290,1026,16.2
45,11,"Barnwell County, SC",Barnwell County, SC,2011,9203,7802,1401,15.2
45,13,"Beaufort County, SC",Beaufort County, SC,2011,65471,59779,5692,8.7
45,15,"Berkeley County, SC",Berkeley County, SC,2011,85781,77575,8206,9.6
45,17,"Calhoun County, SC",Calhoun County, SC,2011,7093,6216,877,12.4
45,19,"Charleston County, SC",Charleston County, SC,2011,183013,167784,15229,8.3
45,21,"Cherokee County, SC",Cherokee County, SC,2011,23645,20163,3482,14.7
45,23,"Chester County, SC",Chester County, SC,2011,14407,11910,2497,17.3
45,25,"Chesterfield County, SC",Chesterfield County, SC,2011,21163,18442,2721,12.9
45,27,"Clarendon County, SC",Clarendon County, SC,2011,13640,11661,1979,14.5
45,29,"Colleton County, SC",Colleton County, SC,2011,16662,14309,2353,14.1
45,31,"Darlington County, SC",Darlington County, SC,2011,30451,26518,3933,12.9
45,33,"Dillon County, SC",Dillon County, SC,2011,13655,11496,2159,15.8
45,35,"Dorchester County, SC",Dorchester County, SC,2011,67007,60999,6008,9
45,37,"Edgefield County, SC",Edgefield County, SC,2011,10914,9830,1084,9.9
45,39,"Fairfield County, SC",Fairfield County, SC,2011,10548,9017,1531,14.5
45,41,"Florence County, SC",Florence County, SC,2011,64432,57199,7233,11.2
45,43,"Georgetown County, SC",Georgetown County, SC,2011,25532,22064,3468,13.6
45,45,"Greenville County, SC",Greenville County, SC,2011,224180,204800,19380,8.6
45,47,"Greenwood County, SC",Greenwood County, SC,2011,32040,28404,3636,11.3
45,49,"Hampton County, SC",Hampton County, SC,2011,8635,7517,1118,12.9
45,51,"Horry County, SC",Horry County, SC,2011,132347,116581,15766,11.9
45,53,"Jasper County, SC",Jasper County, SC,2011,10993,9904,1089,9.9
45,55,"Kershaw County, SC",Kershaw County, SC,2011,28182,25075,3107,11
45,57,"Lancaster County, SC",Lancaster County, SC,2011,34143,29591,4552,13.3
45,59,"Laurens County, SC",Laurens County, SC,2011,30351,26824,3527,11.6
45,61,"Lee County, SC",Lee County, SC,2011,6880,5765,1115,16.2
45,63,"Lexington County, SC",Lexington County, SC,2011,134347,123624,10723,8
45,65,"McCormick County, SC",McCormick County, SC,2011,3633,3138,495,13.6
45,67,"Marion County, SC",Marion County, SC,2011,14165,11655,2510,17.7
45,69,"Marlboro County, SC",Marlboro County, SC,2011,10748,8632,2116,19.7
45,71,"Newberry County, SC",Newberry County, SC,2011,18577,16653,1924,10.4
45,73,"Oconee County, SC",Oconee County, SC,2011,33273,29936,3337,10
45,75,"Orangeburg County, SC",Orangeburg County, SC,2011,40242,33878,6364,15.8
45,77,"Pickens County, SC",Pickens County, SC,2011,54731,49327,5404,9.9
45,79,"Richland County, SC",Richland County, SC,2011,186486,169287,17199,9.2
45,81,"Saluda County, SC",Saluda County, SC,2011,8672,7826,846,9.8
45,83,"Spartanburg County, SC",Spartanburg County, SC,2011,133263,118720,14543,10.9
45,85,"Sumter County, SC",Sumter County, SC,2011,44815,39406,5409,12.1
45,87,"Union County, SC",Union County, SC,2011,12233,10272,1961,16
45,89,"Williamsburg County, SC",Williamsburg County, SC,2011,13427,11185,2242,16.7
45,91,"York County, SC",York County, SC,2011,116971,104192,12779,10.9
46,3,"Aurora County, SD",Aurora County, SD,2011,1668,1615,53,3.2
46,5,"Beadle County, SD",Beadle County, SD,2011,9489,9130,359,3.8
46,7,"Bennett County, SD",Bennett County, SD,2011,1179,1093,86,7.3
46,9,"Bon Homme County, SD",Bon Homme County, SD,2011,3116,2961,155,5
46,11,"Brookings County, SD",Brookings County, SD,2011,17880,17088,792,4.4
46,13,"Brown County, SD",Brown County, SD,2011,20762,19962,800,3.9
46,15,"Brule County, SD",Brule County, SD,2011,2711,2601,110,4.1
46,17,"Buffalo County, SD",Buffalo County, SD,2011,735,659,76,10.3
46,19,"Butte County, SD",Butte County, SD,2011,5021,4775,246,4.9
46,21,"Campbell County, SD",Campbell County, SD,2011,870,836,34,3.9
46,23,"Charles Mix County, SD",Charles Mix County, SD,2011,4126,3921,205,5
46,25,"Clark County, SD",Clark County, SD,2011,1945,1852,93,4.8
46,27,"Clay County, SD",Clay County, SD,2011,7485,7182,303,4
46,29,"Codington County, SD",Codington County, SD,2011,15344,14645,699,4.6
46,31,"Corson County, SD",Corson County, SD,2011,1534,1419,115,7.5
46,33,"Custer County, SD",Custer County, SD,2011,4071,3843,228,5.6
46,35,"Davison County, SD",Davison County, SD,2011,11053,10617,436,3.9
46,37,"Day County, SD",Day County, SD,2011,3047,2848,199,6.5
46,39,"Deuel County, SD",Deuel County, SD,2011,2514,2361,153,6.1
46,41,"Dewey County, SD",Dewey County, SD,2011,2411,2020,391,16.2
46,43,"Douglas County, SD",Douglas County, SD,2011,1752,1681,71,4.1
46,45,"Edmunds County, SD",Edmunds County, SD,2011,2353,2275,78,3.3
46,47,"Fall River County, SD",Fall River County, SD,2011,3188,2997,191,6
46,49,"Faulk County, SD",Faulk County, SD,2011,1171,1122,49,4.2
46,51,"Grant County, SD",Grant County, SD,2011,4617,4395,222,4.8
46,53,"Gregory County, SD",Gregory County, SD,2011,2159,2060,99,4.6
46,55,"Haakon County, SD",Haakon County, SD,2011,1110,1069,41,3.7
46,57,"Hamlin County, SD",Hamlin County, SD,2011,3096,2958,138,4.5
46,59,"Hand County, SD",Hand County, SD,2011,1862,1800,62,3.3
46,61,"Hanson County, SD",Hanson County, SD,2011,1800,1713,87,4.8
46,63,"Harding County, SD",Harding County, SD,2011,820,787,33,4
46,65,"Hughes County, SD",Hughes County, SD,2011,9966,9603,363,3.6
46,67,"Hutchinson County, SD",Hutchinson County, SD,2011,3781,3636,145,3.8
46,69,"Hyde County, SD",Hyde County, SD,2011,784,755,29,3.7
46,71,"Jackson County, SD",Jackson County, SD,2011,1384,1280,104,7.5
46,73,"Jerauld County, SD",Jerauld County, SD,2011,1231,1187,44,3.6
46,75,"Jones County, SD",Jones County, SD,2011,671,649,22,3.3
46,77,"Kingsbury County, SD",Kingsbury County, SD,2011,2875,2748,127,4.4
46,79,"Lake County, SD",Lake County, SD,2011,6188,5881,307,5
46,81,"Lawrence County, SD",Lawrence County, SD,2011,12810,12192,618,4.8
46,83,"Lincoln County, SD",Lincoln County, SD,2011,26916,25947,969,3.6
46,85,"Lyman County, SD",Lyman County, SD,2011,1906,1784,122,6.4
46,87,"McCook County, SD",McCook County, SD,2011,3177,3036,141,4.4
46,89,"McPherson County, SD",McPherson County, SD,2011,1163,1111,52,4.5
46,91,"Marshall County, SD",Marshall County, SD,2011,2497,2357,140,5.6
46,93,"Meade County, SD",Meade County, SD,2011,13070,12435,635,4.9
46,95,"Mellette County, SD",Mellette County, SD,2011,862,807,55,6.4
46,97,"Miner County, SD",Miner County, SD,2011,1295,1237,58,4.5
46,99,"Minnehaha County, SD",Minnehaha County, SD,2011,99299,94839,4460,4.5
46,101,"Moody County, SD",Moody County, SD,2011,4125,3861,264,6.4
46,102,"Oglala Lakota County, SD",Oglala Lakota County, SD,2011,3727,3199,528,14.2
46,103,"Pennington County, SD",Pennington County, SD,2011,52955,50393,2562,4.8
46,105,"Perkins County, SD",Perkins County, SD,2011,1570,1502,68,4.3
46,107,"Potter County, SD",Potter County, SD,2011,1238,1172,66,5.3
46,109,"Roberts County, SD",Roberts County, SD,2011,5032,4694,338,6.7
46,111,"Sanborn County, SD",Sanborn County, SD,2011,1332,1276,56,4.2
46,115,"Spink County, SD",Spink County, SD,2011,3487,3342,145,4.2
46,117,"Stanley County, SD",Stanley County, SD,2011,1916,1840,76,4
46,119,"Sully County, SD",Sully County, SD,2011,874,841,33,3.8
46,121,"Todd County, SD",Todd County, SD,2011,3371,3083,288,8.5
46,123,"Tripp County, SD",Tripp County, SD,2011,3247,3125,122,3.8
46,125,"Turner County, SD",Turner County, SD,2011,4810,4612,198,4.1
46,127,"Union County, SD",Union County, SD,2011,7648,7250,398,5.2
46,129,"Walworth County, SD",Walworth County, SD,2011,2362,2196,166,7
46,135,"Yankton County, SD",Yankton County, SD,2011,11417,10908,509,4.5
46,137,"Ziebach County, SD",Ziebach County, SD,2011,1060,992,68,6.4
47,1,"Anderson County, TN",Anderson County, TN,2011,35172,32094,3078,8.8
47,3,"Bedford County, TN",Bedford County, TN,2011,20906,18553,2353,11.3
47,5,"Benton County, TN",Benton County, TN,2011,7132,6319,813,11.4
47,7,"Bledsoe County, TN",Bledsoe County, TN,2011,4496,3989,507,11.3
47,9,"Blount County, TN",Blount County, TN,2011,61745,56702,5043,8.2
47,11,"Bradley County, TN",Bradley County, TN,2011,47447,43224,4223,8.9
47,13,"Campbell County, TN",Campbell County, TN,2011,16122,14233,1889,11.7
47,15,"Cannon County, TN",Cannon County, TN,2011,6093,5465,628,10.3
47,17,"Carroll County, TN",Carroll County, TN,2011,13684,12026,1658,12.1
47,19,"Carter County, TN",Carter County, TN,2011,26279,23643,2636,10
47,21,"Cheatham County, TN",Cheatham County, TN,2011,20332,18608,1724,8.5
47,23,"Chester County, TN",Chester County, TN,2011,8531,7756,775,9.1
47,25,"Claiborne County, TN",Claiborne County, TN,2011,13685,12173,1512,11
47,27,"Clay County, TN",Clay County, TN,2011,3416,3054,362,10.6
47,29,"Cocke County, TN",Cocke County, TN,2011,15778,13699,2079,13.2
47,31,"Coffee County, TN",Coffee County, TN,2011,24717,22264,2453,9.9
47,33,"Crockett County, TN",Crockett County, TN,2011,7327,6555,772,10.5
47,35,"Cumberland County, TN",Cumberland County, TN,2011,23832,21413,2419,10.2
47,37,"Davidson County, TN",Davidson County, TN,2011,350092,323712,26380,7.5
47,39,"Decatur County, TN",Decatur County, TN,2011,5331,4711,620,11.6
47,41,"DeKalb County, TN",DeKalb County, TN,2011,8223,7311,912,11.1
47,43,"Dickson County, TN",Dickson County, TN,2011,24323,22002,2321,9.5
47,45,"Dyer County, TN",Dyer County, TN,2011,17698,15500,2198,12.4
47,47,"Fayette County, TN",Fayette County, TN,2011,18773,16987,1786,9.5
47,49,"Fentress County, TN",Fentress County, TN,2011,7504,6648,856,11.4
47,51,"Franklin County, TN",Franklin County, TN,2011,19291,17486,1805,9.4
47,53,"Gibson County, TN",Gibson County, TN,2011,23852,21129,2723,11.4
47,55,"Giles County, TN",Giles County, TN,2011,14313,12886,1427,10
47,57,"Grainger County, TN",Grainger County, TN,2011,10004,8837,1167,11.7
47,59,"Greene County, TN",Greene County, TN,2011,30708,27208,3500,11.4
47,61,"Grundy County, TN",Grundy County, TN,2011,5534,4847,687,12.4
47,63,"Hamblen County, TN",Hamblen County, TN,2011,28311,25244,3067,10.8
47,65,"Hamilton County, TN",Hamilton County, TN,2011,171726,158391,13335,7.8
47,67,"Hancock County, TN",Hancock County, TN,2011,2429,2092,337,13.9
47,69,"Hardeman County, TN",Hardeman County, TN,2011,10176,8946,1230,12.1
47,71,"Hardin County, TN",Hardin County, TN,2011,11456,10167,1289,11.3
47,73,"Hawkins County, TN",Hawkins County, TN,2011,25738,23191,2547,9.9
47,75,"Haywood County, TN",Haywood County, TN,2011,8503,7327,1176,13.8
47,77,"Henderson County, TN",Henderson County, TN,2011,13586,12071,1515,11.2
47,79,"Henry County, TN",Henry County, TN,2011,14448,12884,1564,10.8
47,81,"Hickman County, TN",Hickman County, TN,2011,10894,9777,1117,10.3
47,83,"Houston County, TN",Houston County, TN,2011,3568,3170,398,11.2
47,85,"Humphreys County, TN",Humphreys County, TN,2011,8849,7923,926,10.5
47,87,"Jackson County, TN",Jackson County, TN,2011,4749,4194,555,11.7
47,89,"Jefferson County, TN",Jefferson County, TN,2011,24314,21765,2549,10.5
47,91,"Johnson County, TN",Johnson County, TN,2011,7529,6660,869,11.5
47,93,"Knox County, TN",Knox County, TN,2011,233360,217245,16115,6.9
47,95,"Lake County, TN",Lake County, TN,2011,2198,1933,265,12.1
47,97,"Lauderdale County, TN",Lauderdale County, TN,2011,10648,9325,1323,12.4
47,99,"Lawrence County, TN",Lawrence County, TN,2011,19253,17245,2008,10.4
47,101,"Lewis County, TN",Lewis County, TN,2011,5255,4576,679,12.9
47,103,"Lincoln County, TN",Lincoln County, TN,2011,15771,14722,1049,6.7
47,105,"Loudon County, TN",Loudon County, TN,2011,22586,20633,1953,8.6
47,107,"McMinn County, TN",McMinn County, TN,2011,23065,20491,2574,11.2
47,109,"McNairy County, TN",McNairy County, TN,2011,10403,9226,1177,11.3
47,111,"Macon County, TN",Macon County, TN,2011,10338,9277,1061,10.3
47,113,"Madison County, TN",Madison County, TN,2011,49066,44498,4568,9.3
47,115,"Marion County, TN",Marion County, TN,2011,12513,11205,1308,10.5
47,117,"Marshall County, TN",Marshall County, TN,2011,14431,12781,1650,11.4
47,119,"Maury County, TN",Maury County, TN,2011,41313,37081,4232,10.2
47,121,"Meigs County, TN",Meigs County, TN,2011,4984,4388,596,12
47,123,"Monroe County, TN",Monroe County, TN,2011,19588,17345,2243,11.5
47,125,"Montgomery County, TN",Montgomery County, TN,2011,77267,70667,6600,8.5
47,127,"Moore County, TN",Moore County, TN,2011,3341,3111,230,6.9
47,129,"Morgan County, TN",Morgan County, TN,2011,8475,7560,915,10.8
47,131,"Obion County, TN",Obion County, TN,2011,15287,13433,1854,12.1
47,133,"Overton County, TN",Overton County, TN,2011,10016,8992,1024,10.2
47,135,"Perry County, TN",Perry County, TN,2011,3030,2676,354,11.7
47,137,"Pickett County, TN",Pickett County, TN,2011,2434,2159,275,11.3
47,139,"Polk County, TN",Polk County, TN,2011,7427,6600,827,11.1
47,141,"Putnam County, TN",Putnam County, TN,2011,34387,31327,3060,8.9
47,143,"Rhea County, TN",Rhea County, TN,2011,13854,12294,1560,11.3
47,145,"Roane County, TN",Roane County, TN,2011,24447,22232,2215,9.1
47,147,"Robertson County, TN",Robertson County, TN,2011,34127,31263,2864,8.4
47,149,"Rutherford County, TN",Rutherford County, TN,2011,144110,132654,11456,7.9
47,151,"Scott County, TN",Scott County, TN,2011,9144,7539,1605,17.6
47,153,"Sequatchie County, TN",Sequatchie County, TN,2011,6093,5471,622,10.2
47,155,"Sevier County, TN",Sevier County, TN,2011,49713,44746,4967,10
47,157,"Shelby County, TN",Shelby County, TN,2011,451309,408345,42964,9.5
47,159,"Smith County, TN",Smith County, TN,2011,8861,7954,907,10.2
47,161,"Stewart County, TN",Stewart County, TN,2011,5657,4955,702,12.4
47,163,"Sullivan County, TN",Sullivan County, TN,2011,74647,68445,6202,8.3
47,165,"Sumner County, TN",Sumner County, TN,2011,84927,78236,6691,7.9
47,167,"Tipton County, TN",Tipton County, TN,2011,28855,25878,2977,10.3
47,169,"Trousdale County, TN",Trousdale County, TN,2011,3762,3370,392,10.4
47,171,"Unicoi County, TN",Unicoi County, TN,2011,7904,7032,872,11
47,173,"Union County, TN",Union County, TN,2011,7846,7048,798,10.2
47,175,"Van Buren County, TN",Van Buren County, TN,2011,2297,2028,269,11.7
47,177,"Warren County, TN",Warren County, TN,2011,17934,16102,1832,10.2
47,179,"Washington County, TN",Washington County, TN,2011,61291,56366,4925,8
47,181,"Wayne County, TN",Wayne County, TN,2011,6812,6080,732,10.7
47,183,"Weakley County, TN",Weakley County, TN,2011,16711,14806,1905,11.4
47,185,"White County, TN",White County, TN,2011,12485,11254,1231,9.9
47,187,"Williamson County, TN",Williamson County, TN,2011,97414,91713,5701,5.9
47,189,"Wilson County, TN",Wilson County, TN,2011,60063,55525,4538,7.6
48,1,"Anderson County, TX",Anderson County, TX,2011,22194,20570,1624,7.3
48,3,"Andrews County, TX",Andrews County, TX,2011,7794,7405,389,5
48,5,"Angelina County, TX",Angelina County, TX,2011,38118,35107,3011,7.9
48,7,"Aransas County, TX",Aransas County, TX,2011,9815,8954,861,8.8
48,9,"Archer County, TX",Archer County, TX,2011,4484,4212,272,6.1
48,11,"Armstrong County, TX",Armstrong County, TX,2011,1037,987,50,4.8
48,13,"Atascosa County, TX",Atascosa County, TX,2011,19891,18303,1588,8
48,15,"Austin County, TX",Austin County, TX,2011,14153,13036,1117,7.9
48,17,"Bailey County, TX",Bailey County, TX,2011,3290,3044,246,7.5
48,19,"Bandera County, TX",Bandera County, TX,2011,9179,8491,688,7.5
48,21,"Bastrop County, TX",Bastrop County, TX,2011,35719,32884,2835,7.9
48,23,"Baylor County, TX",Baylor County, TX,2011,1862,1751,111,6
48,25,"Bee County, TX",Bee County, TX,2011,10591,9683,908,8.6
48,27,"Bell County, TX",Bell County, TX,2011,133465,122763,10702,8
48,29,"Bexar County, TX",Bexar County, TX,2011,829870,770139,59731,7.2
48,31,"Blanco County, TX",Blanco County, TX,2011,5420,5112,308,5.7
48,33,"Borden County, TX",Borden County, TX,2011,389,368,21,5.4
48,35,"Bosque County, TX",Bosque County, TX,2011,8408,7709,699,8.3
48,37,"Bowie County, TX",Bowie County, TX,2011,42338,38833,3505,8.3
48,39,"Brazoria County, TX",Brazoria County, TX,2011,158581,145857,12724,8
48,41,"Brazos County, TX",Brazos County, TX,2011,99772,93755,6017,6
48,43,"Brewster County, TX",Brewster County, TX,2011,4862,4592,270,5.6
48,45,"Briscoe County, TX",Briscoe County, TX,2011,722,678,44,6.1
48,47,"Brooks County, TX",Brooks County, TX,2011,2689,2405,284,10.6
48,49,"Brown County, TX",Brown County, TX,2011,16378,15067,1311,8
48,51,"Burleson County, TX",Burleson County, TX,2011,7764,7199,565,7.3
48,53,"Burnet County, TX",Burnet County, TX,2011,20659,19265,1394,6.7
48,55,"Caldwell County, TX",Caldwell County, TX,2011,16857,15437,1420,8.4
48,57,"Calhoun County, TX",Calhoun County, TX,2011,10602,9698,904,8.5
48,59,"Callahan County, TX",Callahan County, TX,2011,6018,5587,431,7.2
48,61,"Cameron County, TX",Cameron County, TX,2011,165823,146773,19050,11.5
48,63,"Camp County, TX",Camp County, TX,2011,5679,5171,508,8.9
48,65,"Carson County, TX",Carson County, TX,2011,3425,3254,171,5
48,67,"Cass County, TX",Cass County, TX,2011,13305,11888,1417,10.7
48,69,"Castro County, TX",Castro County, TX,2011,4091,3886,205,5
48,71,"Chambers County, TX",Chambers County, TX,2011,16802,15242,1560,9.3
48,73,"Cherokee County, TX",Cherokee County, TX,2011,22209,20404,1805,8.1
48,75,"Childress County, TX",Childress County, TX,2011,3084,2925,159,5.2
48,77,"Clay County, TX",Clay County, TX,2011,5516,5159,357,6.5
48,79,"Cochran County, TX",Cochran County, TX,2011,1498,1371,127,8.5
48,81,"Coke County, TX",Coke County, TX,2011,1536,1448,88,5.7
48,83,"Coleman County, TX",Coleman County, TX,2011,3400,3101,299,8.8
48,85,"Collin County, TX",Collin County, TX,2011,438645,409063,29582,6.7
48,87,"Collingsworth County, TX",Collingsworth County, TX,2011,1307,1231,76,5.8
48,89,"Colorado County, TX",Colorado County, TX,2011,10108,9326,782,7.7
48,91,"Comal County, TX",Comal County, TX,2011,54641,50881,3760,6.9
48,93,"Comanche County, TX",Comanche County, TX,2011,5946,5505,441,7.4
48,95,"Concho County, TX",Concho County, TX,2011,1576,1503,73,4.6
48,97,"Cooke County, TX",Cooke County, TX,2011,20367,19137,1230,6
48,99,"Coryell County, TX",Coryell County, TX,2011,25663,23687,1976,7.7
48,101,"Cottle County, TX",Cottle County, TX,2011,667,617,50,7.5
48,103,"Crane County, TX",Crane County, TX,2011,1919,1792,127,6.6
48,105,"Crockett County, TX",Crockett County, TX,2011,1715,1602,113,6.6
48,107,"Crosby County, TX",Crosby County, TX,2011,3005,2753,252,8.4
48,109,"Culberson County, TX",Culberson County, TX,2011,1018,948,70,6.9
48,111,"Dallam County, TX",Dallam County, TX,2011,4054,3877,177,4.4
48,113,"Dallas County, TX",Dallas County, TX,2011,1212288,1113577,98711,8.1
48,115,"Dawson County, TX",Dawson County, TX,2011,5223,4832,391,7.5
48,117,"Deaf Smith County, TX",Deaf Smith County, TX,2011,9633,9109,524,5.4
48,119,"Delta County, TX",Delta County, TX,2011,2632,2420,212,8.1
48,121,"Denton County, TX",Denton County, TX,2011,379534,354648,24886,6.6
48,123,"DeWitt County, TX",DeWitt County, TX,2011,9475,8864,611,6.4
48,125,"Dickens County, TX",Dickens County, TX,2011,910,771,139,15.3
48,127,"Dimmit County, TX",Dimmit County, TX,2011,4913,4533,380,7.7
48,129,"Donley County, TX",Donley County, TX,2011,1814,1697,117,6.4
48,131,"Duval County, TX",Duval County, TX,2011,5210,4721,489,9.4
48,133,"Eastland County, TX",Eastland County, TX,2011,8421,7775,646,7.7
48,135,"Ector County, TX",Ector County, TX,2011,72809,68356,4453,6.1
48,137,"Edwards County, TX",Edwards County, TX,2011,991,926,65,6.6
48,139,"Ellis County, TX",Ellis County, TX,2011,76874,70912,5962,7.8
48,141,"El Paso County, TX",El Paso County, TX,2011,346748,313903,32845,9.5
48,143,"Erath County, TX",Erath County, TX,2011,20688,19438,1250,6
48,145,"Falls County, TX",Falls County, TX,2011,7185,6591,594,8.3
48,147,"Fannin County, TX",Fannin County, TX,2011,15277,14016,1261,8.3
48,149,"Fayette County, TX",Fayette County, TX,2011,12510,11788,722,5.8
48,151,"Fisher County, TX",Fisher County, TX,2011,1941,1812,129,6.6
48,153,"Floyd County, TX",Floyd County, TX,2011,3328,3072,256,7.7
48,155,"Foard County, TX",Foard County, TX,2011,667,618,49,7.3
48,157,"Fort Bend County, TX",Fort Bend County, TX,2011,308363,286479,21884,7.1
48,159,"Franklin County, TX",Franklin County, TX,2011,4756,4368,388,8.2
48,161,"Freestone County, TX",Freestone County, TX,2011,8079,7447,632,7.8
48,163,"Frio County, TX",Frio County, TX,2011,7973,7455,518,6.5
48,165,"Gaines County, TX",Gaines County, TX,2011,8508,8076,432,5.1
48,167,"Galveston County, TX",Galveston County, TX,2011,149857,136627,13230,8.8
48,169,"Garza County, TX",Garza County, TX,2011,2225,2091,134,6
48,171,"Gillespie County, TX",Gillespie County, TX,2011,12447,11785,662,5.3
48,173,"Glasscock County, TX",Glasscock County, TX,2011,748,716,32,4.3
48,175,"Goliad County, TX",Goliad County, TX,2011,3377,3158,219,6.5
48,177,"Gonzales County, TX",Gonzales County, TX,2011,9474,8891,583,6.2
48,179,"Gray County, TX",Gray County, TX,2011,9634,8979,655,6.8
48,181,"Grayson County, TX",Grayson County, TX,2011,60176,55436,4740,7.9
48,183,"Gregg County, TX",Gregg County, TX,2011,61082,56722,4360,7.1
48,185,"Grimes County, TX",Grimes County, TX,2011,11618,10714,904,7.8
48,187,"Guadalupe County, TX",Guadalupe County, TX,2011,66766,62439,4327,6.5
48,189,"Hale County, TX",Hale County, TX,2011,16238,15023,1215,7.5
48,191,"Hall County, TX",Hall County, TX,2011,1401,1279,122,8.7
48,193,"Hamilton County, TX",Hamilton County, TX,2011,3880,3634,246,6.3
48,195,"Hansford County, TX",Hansford County, TX,2011,3047,2923,124,4.1
48,197,"Hardeman County, TX",Hardeman County, TX,2011,1873,1743,130,6.9
48,199,"Hardin County, TX",Hardin County, TX,2011,26253,23766,2487,9.5
48,201,"Harris County, TX",Harris County, TX,2011,2110507,1944945,165562,7.8
48,203,"Harrison County, TX",Harrison County, TX,2011,31521,28848,2673,8.5
48,205,"Hartley County, TX",Hartley County, TX,2011,2813,2702,111,3.9
48,207,"Haskell County, TX",Haskell County, TX,2011,3039,2876,163,5.4
48,209,"Hays County, TX",Hays County, TX,2011,83333,77746,5587,6.7
48,211,"Hemphill County, TX",Hemphill County, TX,2011,2390,2307,83,3.5
48,213,"Henderson County, TX",Henderson County, TX,2011,35053,32068,2985,8.5
48,215,"Hidalgo County, TX",Hidalgo County, TX,2011,326443,288558,37885,11.6
48,217,"Hill County, TX",Hill County, TX,2011,15891,14582,1309,8.2
48,219,"Hockley County, TX",Hockley County, TX,2011,11360,10641,719,6.3
48,221,"Hood County, TX",Hood County, TX,2011,23627,21752,1875,7.9
48,223,"Hopkins County, TX",Hopkins County, TX,2011,16864,15625,1239,7.3
48,225,"Houston County, TX",Houston County, TX,2011,10660,9830,830,7.8
48,227,"Howard County, TX",Howard County, TX,2011,13256,12390,866,6.5
48,229,"Hudspeth County, TX",Hudspeth County, TX,2011,1388,1277,111,8
48,231,"Hunt County, TX",Hunt County, TX,2011,38438,35040,3398,8.8
48,233,"Hutchinson County, TX",Hutchinson County, TX,2011,9914,9132,782,7.9
48,235,"Irion County, TX",Irion County, TX,2011,877,830,47,5.4
48,237,"Jack County, TX",Jack County, TX,2011,3715,3457,258,6.9
48,239,"Jackson County, TX",Jackson County, TX,2011,7355,6897,458,6.2
48,241,"Jasper County, TX",Jasper County, TX,2011,15035,13180,1855,12.3
48,243,"Jeff Davis County, TX",Jeff Davis County, TX,2011,1251,1189,62,5
48,245,"Jefferson County, TX",Jefferson County, TX,2011,115463,102305,13158,11.4
48,247,"Jim Hogg County, TX",Jim Hogg County, TX,2011,2330,2129,201,8.6
48,249,"Jim Wells County, TX",Jim Wells County, TX,2011,19762,18201,1561,7.9
48,251,"Johnson County, TX",Johnson County, TX,2011,72762,67105,5657,7.8
48,253,"Jones County, TX",Jones County, TX,2011,6138,5630,508,8.3
48,255,"Karnes County, TX",Karnes County, TX,2011,4887,4508,379,7.8
48,257,"Kaufman County, TX",Kaufman County, TX,2011,51525,47390,4135,8
48,259,"Kendall County, TX",Kendall County, TX,2011,16921,15894,1027,6.1
48,261,"Kenedy County, TX",Kenedy County, TX,2011,238,223,15,6.3
48,263,"Kent County, TX",Kent County, TX,2011,554,528,26,4.7
48,265,"Kerr County, TX",Kerr County, TX,2011,21830,20375,1455,6.7
48,267,"Kimble County, TX",Kimble County, TX,2011,2234,2095,139,6.2
48,269,"King County, TX",King County, TX,2011,288,277,11,3.8
48,271,"Kinney County, TX",Kinney County, TX,2011,1271,1142,129,10.1
48,273,"Kleberg County, TX",Kleberg County, TX,2011,15389,14156,1233,8
48,275,"Knox County, TX",Knox County, TX,2011,1906,1796,110,5.8
48,277,"Lamar County, TX",Lamar County, TX,2011,23383,21095,2288,9.8
48,279,"Lamb County, TX",Lamb County, TX,2011,6730,6221,509,7.6
48,281,"Lampasas County, TX",Lampasas County, TX,2011,9139,8448,691,7.6
48,283,"La Salle County, TX",La Salle County, TX,2011,3136,2926,210,6.7
48,285,"Lavaca County, TX",Lavaca County, TX,2011,9621,9049,572,5.9
48,287,"Lee County, TX",Lee County, TX,2011,8870,8297,573,6.5
48,289,"Leon County, TX",Leon County, TX,2011,7158,6537,621,8.7
48,291,"Liberty County, TX",Liberty County, TX,2011,30785,27372,3413,11.1
48,293,"Limestone County, TX",Limestone County, TX,2011,9576,8783,793,8.3
48,295,"Lipscomb County, TX",Lipscomb County, TX,2011,1743,1663,80,4.6
48,297,"Live Oak County, TX",Live Oak County, TX,2011,5234,4923,311,5.9
48,299,"Llano County, TX",Llano County, TX,2011,8014,7394,620,7.7
48,301,"Loving County, TX",Loving County, TX,2011,66,62,4,6.1
48,303,"Lubbock County, TX",Lubbock County, TX,2011,145820,137065,8755,6
48,305,"Lynn County, TX",Lynn County, TX,2011,3084,2881,203,6.6
48,307,"McCulloch County, TX",McCulloch County, TX,2011,4360,4102,258,5.9
48,309,"McLennan County, TX",McLennan County, TX,2011,113365,104945,8420,7.4
48,311,"McMullen County, TX",McMullen County, TX,2011,660,640,20,3
48,313,"Madison County, TX",Madison County, TX,2011,4682,4295,387,8.3
48,315,"Marion County, TX",Marion County, TX,2011,4423,3962,461,10.4
48,317,"Martin County, TX",Martin County, TX,2011,2351,2220,131,5.6
48,319,"Mason County, TX",Mason County, TX,2011,1965,1847,118,6
48,321,"Matagorda County, TX",Matagorda County, TX,2011,17794,15732,2062,11.6
48,323,"Maverick County, TX",Maverick County, TX,2011,23914,20560,3354,14
48,325,"Medina County, TX",Medina County, TX,2011,20245,18733,1512,7.5
48,327,"Menard County, TX",Menard County, TX,2011,945,877,68,7.2
48,329,"Midland County, TX",Midland County, TX,2011,76676,73030,3646,4.8
48,331,"Milam County, TX",Milam County, TX,2011,10409,9350,1059,10.2
48,333,"Mills County, TX",Mills County, TX,2011,2173,2036,137,6.3
48,335,"Mitchell County, TX",Mitchell County, TX,2011,2943,2722,221,7.5
48,337,"Montague County, TX",Montague County, TX,2011,9602,8978,624,6.5
48,339,"Montgomery County, TX",Montgomery County, TX,2011,231782,215406,16376,7.1
48,341,"Moore County, TX",Moore County, TX,2011,11759,11192,567,4.8
48,343,"Morris County, TX",Morris County, TX,2011,5814,5116,698,12
48,345,"Motley County, TX",Motley County, TX,2011,594,553,41,6.9
48,347,"Nacogdoches County, TX",Nacogdoches County, TX,2011,30628,28488,2140,7
48,349,"Navarro County, TX",Navarro County, TX,2011,23085,21215,1870,8.1
48,351,"Newton County, TX",Newton County, TX,2011,6040,5271,769,12.7
48,353,"Nolan County, TX",Nolan County, TX,2011,7352,6837,515,7
48,355,"Nueces County, TX",Nueces County, TX,2011,164278,151227,13051,7.9
48,357,"Ochiltree County, TX",Ochiltree County, TX,2011,5108,4862,246,4.8
48,359,"Oldham County, TX",Oldham County, TX,2011,980,938,42,4.3
48,361,"Orange County, TX",Orange County, TX,2011,39187,34675,4512,11.5
48,363,"Palo Pinto County, TX",Palo Pinto County, TX,2011,13481,12414,1067,7.9
48,365,"Panola County, TX",Panola County, TX,2011,11944,10968,976,8.2
48,367,"Parker County, TX",Parker County, TX,2011,57353,53403,3950,6.9
48,369,"Parmer County, TX",Parmer County, TX,2011,5292,5057,235,4.4
48,371,"Pecos County, TX",Pecos County, TX,2011,7199,6767,432,6
48,373,"Polk County, TX",Polk County, TX,2011,17651,16004,1647,9.3
48,375,"Potter County, TX",Potter County, TX,2011,58757,55265,3492,5.9
48,377,"Presidio County, TX",Presidio County, TX,2011,3781,3207,574,15.2
48,379,"Rains County, TX",Rains County, TX,2011,5168,4744,424,8.2
48,381,"Randall County, TX",Randall County, TX,2011,68124,64749,3375,5
48,383,"Reagan County, TX",Reagan County, TX,2011,2018,1930,88,4.4
48,385,"Real County, TX",Real County, TX,2011,1136,1024,112,9.9
48,387,"Red River County, TX",Red River County, TX,2011,5493,4829,664,12.1
48,389,"Reeves County, TX",Reeves County, TX,2011,5543,5098,445,8
48,391,"Refugio County, TX",Refugio County, TX,2011,3419,3160,259,7.6
48,393,"Roberts County, TX",Roberts County, TX,2011,480,456,24,5
48,395,"Robertson County, TX",Robertson County, TX,2011,7544,6851,693,9.2
48,397,"Rockwall County, TX",Rockwall County, TX,2011,40616,37737,2879,7.1
48,399,"Runnels County, TX",Runnels County, TX,2011,5108,4734,374,7.3
48,401,"Rusk County, TX",Rusk County, TX,2011,24286,22576,1710,7
48,403,"Sabine County, TX",Sabine County, TX,2011,3462,2917,545,15.7
48,405,"San Augustine County, TX",San Augustine County, TX,2011,3154,2708,446,14.1
48,407,"San Jacinto County, TX",San Jacinto County, TX,2011,11367,10270,1097,9.7
48,409,"San Patricio County, TX",San Patricio County, TX,2011,30231,27295,2936,9.7
48,411,"San Saba County, TX",San Saba County, TX,2011,2522,2369,153,6.1
48,413,"Schleicher County, TX",Schleicher County, TX,2011,1699,1603,96,5.7
48,415,"Scurry County, TX",Scurry County, TX,2011,7407,6987,420,5.7
48,417,"Shackelford County, TX",Shackelford County, TX,2011,2007,1912,95,4.7
48,419,"Shelby County, TX",Shelby County, TX,2011,11977,10952,1025,8.6
48,421,"Sherman County, TX",Sherman County, TX,2011,1578,1506,72,4.6
48,423,"Smith County, TX",Smith County, TX,2011,102136,94189,7947,7.8
48,425,"Somervell County, TX",Somervell County, TX,2011,4084,3767,317,7.8
48,427,"Starr County, TX",Starr County, TX,2011,26168,21930,4238,16.2
48,429,"Stephens County, TX",Stephens County, TX,2011,4440,4095,345,7.8
48,431,"Sterling County, TX",Sterling County, TX,2011,682,649,33,4.8
48,433,"Stonewall County, TX",Stonewall County, TX,2011,746,705,41,5.5
48,435,"Sutton County, TX",Sutton County, TX,2011,1947,1815,132,6.8
48,437,"Swisher County, TX",Swisher County, TX,2011,3152,2940,212,6.7
48,439,"Tarrant County, TX",Tarrant County, TX,2011,950514,878726,71788,7.6
48,441,"Taylor County, TX",Taylor County, TX,2011,64678,60429,4249,6.6
48,443,"Terrell County, TX",Terrell County, TX,2011,518,486,32,6.2
48,445,"Terry County, TX",Terry County, TX,2011,5853,5437,416,7.1
48,447,"Throckmorton County, TX",Throckmorton County, TX,2011,873,812,61,7
48,449,"Titus County, TX",Titus County, TX,2011,13719,12590,1129,8.2
48,451,"Tom Green County, TX",Tom Green County, TX,2011,53262,49931,3331,6.3
48,453,"Travis County, TX",Travis County, TX,2011,594040,556184,37856,6.4
48,455,"Trinity County, TX",Trinity County, TX,2011,5719,5173,546,9.5
48,457,"Tyler County, TX",Tyler County, TX,2011,7842,6898,944,12
48,459,"Upshur County, TX",Upshur County, TX,2011,18615,17133,1482,8
48,461,"Upton County, TX",Upton County, TX,2011,1571,1488,83,5.3
48,463,"Uvalde County, TX",Uvalde County, TX,2011,12144,11066,1078,8.9
48,465,"Val Verde County, TX",Val Verde County, TX,2011,20461,18625,1836,9
48,467,"Van Zandt County, TX",Van Zandt County, TX,2011,23741,21848,1893,8
48,469,"Victoria County, TX",Victoria County, TX,2011,43741,40791,2950,6.7
48,471,"Walker County, TX",Walker County, TX,2011,23171,21352,1819,7.9
48,473,"Waller County, TX",Waller County, TX,2011,20344,18677,1667,8.2
48,475,"Ward County, TX",Ward County, TX,2011,4940,4619,321,6.5
48,477,"Washington County, TX",Washington County, TX,2011,15682,14646,1036,6.6
48,479,"Webb County, TX",Webb County, TX,2011,107892,99885,8007,7.4
48,481,"Wharton County, TX",Wharton County, TX,2011,21498,19723,1775,8.3
48,483,"Wheeler County, TX",Wheeler County, TX,2011,2856,2715,141,4.9
48,485,"Wichita County, TX",Wichita County, TX,2011,59026,54960,4066,6.9
48,487,"Wilbarger County, TX",Wilbarger County, TX,2011,6039,5601,438,7.3
48,489,"Willacy County, TX",Willacy County, TX,2011,7721,6450,1271,16.5
48,491,"Williamson County, TX",Williamson County, TX,2011,230895,215239,15656,6.8
48,493,"Wilson County, TX",Wilson County, TX,2011,21547,20142,1405,6.5
48,495,"Winkler County, TX",Winkler County, TX,2011,3051,2834,217,7.1
48,497,"Wise County, TX",Wise County, TX,2011,28152,26022,2130,7.6
48,499,"Wood County, TX",Wood County, TX,2011,16973,15506,1467,8.6
48,501,"Yoakum County, TX",Yoakum County, TX,2011,4165,3948,217,5.2
48,503,"Young County, TX",Young County, TX,2011,8593,7978,615,7.2
48,505,"Zapata County, TX",Zapata County, TX,2011,6467,5944,523,8.1
48,507,"Zavala County, TX",Zavala County, TX,2011,4590,3944,646,14.1
49,1,"Beaver County, UT",Beaver County, UT,2011,3044,2800,244,8
49,3,"Box Elder County, UT",Box Elder County, UT,2011,23186,21444,1742,7.5
49,5,"Cache County, UT",Cache County, UT,2011,56612,53638,2974,5.3
49,7,"Carbon County, UT",Carbon County, UT,2011,9547,8824,723,7.6
49,9,"Daggett County, UT",Daggett County, UT,2011,471,442,29,6.2
49,11,"Davis County, UT",Davis County, UT,2011,146629,137787,8842,6
49,13,"Duchesne County, UT",Duchesne County, UT,2011,8445,7882,563,6.7
49,15,"Emery County, UT",Emery County, UT,2011,5070,4698,372,7.3
49,17,"Garfield County, UT",Garfield County, UT,2011,2962,2646,316,10.7
49,19,"Grand County, UT",Grand County, UT,2011,5317,4797,520,9.8
49,21,"Iron County, UT",Iron County, UT,2011,19868,18227,1641,8.3
49,23,"Juab County, UT",Juab County, UT,2011,4595,4219,376,8.2
49,25,"Kane County, UT",Kane County, UT,2011,3492,3232,260,7.4
49,27,"Millard County, UT",Millard County, UT,2011,6169,5842,327,5.3
49,29,"Morgan County, UT",Morgan County, UT,2011,4245,4002,243,5.7
49,31,"Piute County, UT",Piute County, UT,2011,530,477,53,10
49,33,"Rich County, UT",Rich County, UT,2011,982,911,71,7.2
49,35,"Salt Lake County, UT",Salt Lake County, UT,2011,546296,510115,36181,6.6
49,37,"San Juan County, UT",San Juan County, UT,2011,5954,5359,595,10
49,39,"Sanpete County, UT",Sanpete County, UT,2011,11110,10235,875,7.9
49,41,"Sevier County, UT",Sevier County, UT,2011,9502,8796,706,7.4
49,43,"Summit County, UT",Summit County, UT,2011,21205,19912,1293,6.1
49,45,"Tooele County, UT",Tooele County, UT,2011,27279,25330,1949,7.1
49,47,"Uintah County, UT",Uintah County, UT,2011,15518,14585,933,6
49,49,"Utah County, UT",Utah County, UT,2011,231181,216636,14545,6.3
49,51,"Wasatch County, UT",Wasatch County, UT,2011,11381,10584,797,7
49,53,"Washington County, UT",Washington County, UT,2011,55996,51025,4971,8.9
49,55,"Wayne County, UT",Wayne County, UT,2011,1430,1286,144,10.1
49,57,"Weber County, UT",Weber County, UT,2011,112431,103607,8824,7.8
50,1,"Addison County, VT",Addison County, VT,2011,21184,20118,1066,5
50,3,"Bennington County, VT",Bennington County, VT,2011,19969,18684,1285,6.4
50,5,"Caledonia County, VT",Caledonia County, VT,2011,16572,15533,1039,6.3
50,7,"Chittenden County, VT",Chittenden County, VT,2011,95361,91430,3931,4.1
50,9,"Essex County, VT",Essex County, VT,2011,3070,2810,260,8.5
50,11,"Franklin County, VT",Franklin County, VT,2011,27949,26471,1478,5.3
50,13,"Grand Isle County, VT",Grand Isle County, VT,2011,4169,3900,269,6.5
50,15,"Lamoille County, VT",Lamoille County, VT,2011,14585,13556,1029,7.1
50,17,"Orange County, VT",Orange County, VT,2011,16608,15721,887,5.3
50,19,"Orleans County, VT",Orleans County, VT,2011,14191,12983,1208,8.5
50,21,"Rutland County, VT",Rutland County, VT,2011,33259,31004,2255,6.8
50,23,"Washington County, VT",Washington County, VT,2011,34872,33013,1859,5.3
50,25,"Windham County, VT",Windham County, VT,2011,24977,23577,1400,5.6
50,27,"Windsor County, VT",Windsor County, VT,2011,31342,29664,1678,5.4
51,1,"Accomack County, VA",Accomack County, VA,2011,16591,15198,1393,8.4
51,3,"Albemarle County, VA",Albemarle County, VA,2011,52161,49252,2909,5.6
51,5,"Alleghany County, VA",Alleghany County, VA,2011,7908,7286,622,7.9
51,7,"Amelia County, VA",Amelia County, VA,2011,6262,5793,469,7.5
51,9,"Amherst County, VA",Amherst County, VA,2011,16181,15003,1178,7.3
51,11,"Appomattox County, VA",Appomattox County, VA,2011,7262,6684,578,8
51,13,"Arlington County, VA",Arlington County, VA,2011,141853,136519,5334,3.8
51,15,"Augusta County, VA",Augusta County, VA,2011,37430,35060,2370,6.3
51,17,"Bath County, VA",Bath County, VA,2011,2576,2413,163,6.3
51,19,"Bedford County, VA",Bedford County, VA,2011,38817,36307,2510,6.5
51,21,"Bland County, VA",Bland County, VA,2011,2859,2647,212,7.4
51,23,"Botetourt County, VA",Botetourt County, VA,2011,17729,16689,1040,5.9
51,25,"Brunswick County, VA",Brunswick County, VA,2011,6818,6098,720,10.6
51,27,"Buchanan County, VA",Buchanan County, VA,2011,8475,7750,725,8.6
51,29,"Buckingham County, VA",Buckingham County, VA,2011,6594,5963,631,9.6
51,31,"Campbell County, VA",Campbell County, VA,2011,27607,25629,1978,7.2
51,33,"Caroline County, VA",Caroline County, VA,2011,14477,13175,1302,9
51,35,"Carroll County, VA",Carroll County, VA,2011,13630,12285,1345,9.9
51,36,"Charles City County, VA",Charles City County, VA,2011,3937,3583,354,9
51,37,"Charlotte County, VA",Charlotte County, VA,2011,5399,4871,528,9.8
51,41,"Chesterfield County, VA",Chesterfield County, VA,2011,171539,159940,11599,6.8
51,43,"Clarke County, VA",Clarke County, VA,2011,7773,7328,445,5.7
51,45,"Craig County, VA",Craig County, VA,2011,2481,2294,187,7.5
51,47,"Culpeper County, VA",Culpeper County, VA,2011,23396,21907,1489,6.4
51,49,"Cumberland County, VA",Cumberland County, VA,2011,4561,4212,349,7.7
51,51,"Dickenson County, VA",Dickenson County, VA,2011,5459,4920,539,9.9
51,53,"Dinwiddie County, VA",Dinwiddie County, VA,2011,13643,12555,1088,8
51,57,"Essex County, VA",Essex County, VA,2011,5699,5226,473,8.3
51,59,"Fairfax County, VA",Fairfax County, VA,2011,620196,590686,29510,4.8
51,61,"Fauquier County, VA",Fauquier County, VA,2011,36127,34137,1990,5.5
51,63,"Floyd County, VA",Floyd County, VA,2011,8334,7806,528,6.3
51,65,"Fluvanna County, VA",Fluvanna County, VA,2011,13266,12494,772,5.8
51,67,"Franklin County, VA",Franklin County, VA,2011,27679,25608,2071,7.5
51,69,"Frederick County, VA",Frederick County, VA,2011,43199,40397,2802,6.5
51,71,"Giles County, VA",Giles County, VA,2011,8274,7613,661,8
51,73,"Gloucester County, VA",Gloucester County, VA,2011,19550,18323,1227,6.3
51,75,"Goochland County, VA",Goochland County, VA,2011,10374,9716,658,6.3
51,77,"Grayson County, VA",Grayson County, VA,2011,7206,6424,782,10.9
51,79,"Greene County, VA",Greene County, VA,2011,9792,9201,591,6
51,81,"Greensville County, VA",Greensville County, VA,2011,4581,4179,402,8.8
51,83,"Halifax County, VA",Halifax County, VA,2011,16361,14564,1797,11
51,85,"Hanover County, VA",Hanover County, VA,2011,54957,51675,3282,6
51,87,"Henrico County, VA",Henrico County, VA,2011,170535,159037,11498,6.7
51,89,"Henry County, VA",Henry County, VA,2011,22821,19949,2872,12.6
51,91,"Highland County, VA",Highland County, VA,2011,1460,1378,82,5.6
51,93,"Isle of Wight County, VA",Isle of Wight County, VA,2011,18880,17569,1311,6.9
51,95,"James City County, VA",James City County, VA,2011,32605,30618,1987,6.1
51,97,"King and Queen County, VA",King and Queen County, VA,2011,3664,3394,270,7.4
51,99,"King George County, VA",King George County, VA,2011,11721,10904,817,7
51,101,"King William County, VA",King William County, VA,2011,8703,8104,599,6.9
51,103,"Lancaster County, VA",Lancaster County, VA,2011,5590,5072,518,9.3
51,105,"Lee County, VA",Lee County, VA,2011,10229,9451,778,7.6
51,107,"Loudoun County, VA",Loudoun County, VA,2011,181515,173042,8473,4.7
51,109,"Louisa County, VA",Louisa County, VA,2011,17943,16717,1226,6.8
51,111,"Lunenburg County, VA",Lunenburg County, VA,2011,5511,5039,472,8.6
51,113,"Madison County, VA",Madison County, VA,2011,7223,6844,379,5.2
51,115,"Mathews County, VA",Mathews County, VA,2011,4244,3967,277,6.5
51,117,"Mecklenburg County, VA",Mecklenburg County, VA,2011,14059,12599,1460,10.4
51,119,"Middlesex County, VA",Middlesex County, VA,2011,5138,4805,333,6.5
51,121,"Montgomery County, VA",Montgomery County, VA,2011,48374,45309,3065,6.3
51,125,"Nelson County, VA",Nelson County, VA,2011,7604,7123,481,6.3
51,127,"New Kent County, VA",New Kent County, VA,2011,10439,9770,669,6.4
51,131,"Northampton County, VA",Northampton County, VA,2011,6364,5799,565,8.9
51,133,"Northumberland County, VA",Northumberland County, VA,2011,6031,5489,542,9
51,135,"Nottoway County, VA",Nottoway County, VA,2011,6893,6400,493,7.2
51,137,"Orange County, VA",Orange County, VA,2011,15788,14606,1182,7.5
51,139,"Page County, VA",Page County, VA,2011,12491,11106,1385,11.1
51,141,"Patrick County, VA",Patrick County, VA,2011,8048,7179,869,10.8
51,143,"Pittsylvania County, VA",Pittsylvania County, VA,2011,31169,28329,2840,9.1
51,145,"Powhatan County, VA",Powhatan County, VA,2011,13555,12708,847,6.2
51,147,"Prince Edward County, VA",Prince Edward County, VA,2011,10386,9450,936,9
51,149,"Prince George County, VA",Prince George County, VA,2011,14530,13396,1134,7.8
51,153,"Prince William County, VA",Prince William County, VA,2011,225195,212446,12749,5.7
51,155,"Pulaski County, VA",Pulaski County, VA,2011,16880,15413,1467,8.7
51,157,"Rappahannock County, VA",Rappahannock County, VA,2011,4003,3778,225,5.6
51,159,"Richmond County, VA",Richmond County, VA,2011,4267,3982,285,6.7
51,161,"Roanoke County, VA",Roanoke County, VA,2011,49724,46896,2828,5.7
51,163,"Rockbridge County, VA",Rockbridge County, VA,2011,11010,10263,747,6.8
51,165,"Rockingham County, VA",Rockingham County, VA,2011,41314,38822,2492,6
51,167,"Russell County, VA",Russell County, VA,2011,11942,10809,1133,9.5
51,169,"Scott County, VA",Scott County, VA,2011,10156,9411,745,7.3
51,171,"Shenandoah County, VA",Shenandoah County, VA,2011,21084,19597,1487,7.1
51,173,"Smyth County, VA",Smyth County, VA,2011,13750,12250,1500,10.9
51,175,"Southampton County, VA",Southampton County, VA,2011,9441,8715,726,7.7
51,177,"Spotsylvania County, VA",Spotsylvania County, VA,2011,64277,59971,4306,6.7
51,179,"Stafford County, VA",Stafford County, VA,2011,65148,61126,4022,6.2
51,181,"Surry County, VA",Surry County, VA,2011,3760,3442,318,8.5
51,183,"Sussex County, VA",Sussex County, VA,2011,4381,3922,459,10.5
51,185,"Tazewell County, VA",Tazewell County, VA,2011,18195,16749,1446,7.9
51,187,"Warren County, VA",Warren County, VA,2011,20119,18629,1490,7.4
51,191,"Washington County, VA",Washington County, VA,2011,27899,25914,1985,7.1
51,193,"Westmoreland County, VA",Westmoreland County, VA,2011,9402,8695,707,7.5
51,195,"Wise County, VA",Wise County, VA,2011,17257,15933,1324,7.7
51,197,"Wythe County, VA",Wythe County, VA,2011,14385,13062,1323,9.2
51,199,"York County, VA",York County, VA,2011,31907,29945,1962,6.1
51,510,"Alexandria city, VA",Alexandria city, VA,2011,92505,88377,4128,4.5
51,520,"Bristol city, VA",Bristol city, VA,2011,8098,7426,672,8.3
51,530,"Buena Vista city, VA",Buena Vista city, VA,2011,3240,2944,296,9.1
51,540,"Charlottesville city, VA",Charlottesville city, VA,2011,23247,21947,1300,5.6
51,550,"Chesapeake city, VA",Chesapeake city, VA,2011,114650,106720,7930,6.9
51,570,"Colonial Heights city, VA",Colonial Heights city, VA,2011,8560,7915,645,7.5
51,580,"Covington city, VA",Covington city, VA,2011,2663,2413,250,9.4
51,590,"Danville city, VA",Danville city, VA,2011,20279,17918,2361,11.6
51,595,"Emporia city, VA",Emporia city, VA,2011,2557,2280,277,10.8
51,600,"Fairfax city, VA",Fairfax city, VA,2011,12712,12087,625,4.9
51,610,"Falls Church city, VA",Falls Church city, VA,2011,7517,7198,319,4.2
51,620,"Franklin city, VA",Franklin city, VA,2011,3672,3255,417,11.4
51,630,"Fredericksburg city, VA",Fredericksburg city, VA,2011,13068,12022,1046,8
51,640,"Galax city, VA",Galax city, VA,2011,3105,2784,321,10.3
51,650,"Hampton city, VA",Hampton city, VA,2011,66445,60507,5938,8.9
51,660,"Harrisonburg city, VA",Harrisonburg city, VA,2011,23788,21933,1855,7.8
51,670,"Hopewell city, VA",Hopewell city, VA,2011,9911,8791,1120,11.3
51,678,"Lexington city, VA",Lexington city, VA,2011,2293,2083,210,9.2
51,680,"Lynchburg city, VA",Lynchburg city, VA,2011,35762,32878,2884,8.1
51,683,"Manassas city, VA",Manassas city, VA,2011,21403,20099,1304,6.1
51,685,"Manassas Park city, VA",Manassas Park city, VA,2011,8634,8151,483,5.6
51,690,"Martinsville city, VA",Martinsville city, VA,2011,5902,5005,897,15.2
51,700,"Newport News city, VA",Newport News city, VA,2011,90697,83305,7392,8.2
51,710,"Norfolk city, VA",Norfolk city, VA,2011,112932,103527,9405,8.3
51,720,"Norton city, VA",Norton city, VA,2011,2113,1966,147,7
51,730,"Petersburg city, VA",Petersburg city, VA,2011,13714,11950,1764,12.9
51,735,"Poquoson city, VA",Poquoson city, VA,2011,6369,6005,364,5.7
51,740,"Portsmouth city, VA",Portsmouth city, VA,2011,45777,41496,4281,9.4
51,750,"Radford city, VA",Radford city, VA,2011,8082,7401,681,8.4
51,760,"Richmond city, VA",Richmond city, VA,2011,107647,98520,9127,8.5
51,770,"Roanoke city, VA",Roanoke city, VA,2011,49488,45492,3996,8.1
51,775,"Salem city, VA",Salem city, VA,2011,12834,12017,817,6.4
51,790,"Staunton city, VA",Staunton city, VA,2011,12005,11154,851,7.1
51,800,"Suffolk city, VA",Suffolk city, VA,2011,41913,38790,3123,7.5
51,810,"Virginia Beach city, VA",Virginia Beach city, VA,2011,229211,215118,14093,6.1
51,820,"Waynesboro city, VA",Waynesboro city, VA,2011,10176,9355,821,8.1
51,830,"Williamsburg city, VA",Williamsburg city, VA,2011,6745,6138,607,9
51,840,"Winchester city, VA",Winchester city, VA,2011,14078,13032,1046,7.4
53,1,"Adams County, WA",Adams County, WA,2011,8257,7425,832,10.1
53,3,"Asotin County, WA",Asotin County, WA,2011,10051,9158,893,8.9
53,5,"Benton County, WA",Benton County, WA,2011,93232,85605,7627,8.2
53,7,"Chelan County, WA",Chelan County, WA,2011,41344,37852,3492,8.4
53,9,"Clallam County, WA",Clallam County, WA,2011,28488,25371,3117,10.9
53,11,"Clark County, WA",Clark County, WA,2011,211481,186816,24665,11.7
53,13,"Columbia County, WA",Columbia County, WA,2011,1854,1680,174,9.4
53,15,"Cowlitz County, WA",Cowlitz County, WA,2011,44774,39434,5340,11.9
53,17,"Douglas County, WA",Douglas County, WA,2011,19341,17533,1808,9.3
53,19,"Ferry County, WA",Ferry County, WA,2011,2528,2088,440,17.4
53,21,"Franklin County, WA",Franklin County, WA,2011,38372,34869,3503,9.1
53,23,"Garfield County, WA",Garfield County, WA,2011,1030,952,78,7.6
53,25,"Grant County, WA",Grant County, WA,2011,42786,38460,4326,10.1
53,27,"Grays Harbor County, WA",Grays Harbor County, WA,2011,29705,25667,4038,13.6
53,29,"Island County, WA",Island County, WA,2011,32640,29678,2962,9.1
53,31,"Jefferson County, WA",Jefferson County, WA,2011,12072,10810,1262,10.5
53,33,"King County, WA",King County, WA,2011,1108838,1020997,87841,7.9
53,35,"Kitsap County, WA",Kitsap County, WA,2011,117324,107470,9854,8.4
53,37,"Kittitas County, WA",Kittitas County, WA,2011,20764,18840,1924,9.3
53,39,"Klickitat County, WA",Klickitat County, WA,2011,10157,8958,1199,11.8
53,41,"Lewis County, WA",Lewis County, WA,2011,32541,28390,4151,12.8
53,43,"Lincoln County, WA",Lincoln County, WA,2011,5298,4868,430,8.1
53,45,"Mason County, WA",Mason County, WA,2011,23792,21005,2787,11.7
53,47,"Okanogan County, WA",Okanogan County, WA,2011,21338,19145,2193,10.3
53,49,"Pacific County, WA",Pacific County, WA,2011,8220,7114,1106,13.5
53,51,"Pend Oreille County, WA",Pend Oreille County, WA,2011,4862,4181,681,14
53,53,"Pierce County, WA",Pierce County, WA,2011,386866,347771,39095,10.1
53,55,"San Juan County, WA",San Juan County, WA,2011,8063,7479,584,7.2
53,57,"Skagit County, WA",Skagit County, WA,2011,57143,51131,6012,10.5
53,59,"Skamania County, WA",Skamania County, WA,2011,5083,4463,620,12.2
53,61,"Snohomish County, WA",Snohomish County, WA,2011,384151,347798,36353,9.5
53,63,"Spokane County, WA",Spokane County, WA,2011,230793,208507,22286,9.7
53,65,"Stevens County, WA",Stevens County, WA,2011,18296,16036,2260,12.4
53,67,"Thurston County, WA",Thurston County, WA,2011,123314,112238,11076,9
53,69,"Wahkiakum County, WA",Wahkiakum County, WA,2011,1429,1224,205,14.3
53,71,"Walla Walla County, WA",Walla Walla County, WA,2011,29623,27252,2371,8
53,73,"Whatcom County, WA",Whatcom County, WA,2011,102743,93483,9260,9
53,75,"Whitman County, WA",Whitman County, WA,2011,22511,21051,1460,6.5
53,77,"Yakima County, WA",Yakima County, WA,2011,120326,107392,12934,10.7
54,1,"Barbour County, WV",Barbour County, WV,2011,6777,6142,635,9.4
54,3,"Berkeley County, WV",Berkeley County, WV,2011,51211,47258,3953,7.7
54,5,"Boone County, WV",Boone County, WV,2011,8680,7980,700,8.1
54,7,"Braxton County, WV",Braxton County, WV,2011,5497,4885,612,11.1
54,9,"Brooke County, WV",Brooke County, WV,2011,10713,9667,1046,9.8
54,11,"Cabell County, WV",Cabell County, WV,2011,42919,39853,3066,7.1
54,13,"Calhoun County, WV",Calhoun County, WV,2011,2867,2504,363,12.7
54,15,"Clay County, WV",Clay County, WV,2011,3573,3132,441,12.3
54,17,"Doddridge County, WV",Doddridge County, WV,2011,3325,3088,237,7.1
54,19,"Fayette County, WV",Fayette County, WV,2011,17734,16146,1588,9
54,21,"Gilmer County, WV",Gilmer County, WV,2011,2815,2586,229,8.1
54,23,"Grant County, WV",Grant County, WV,2011,6190,5634,556,9
54,25,"Greenbrier County, WV",Greenbrier County, WV,2011,15567,14268,1299,8.3
54,27,"Hampshire County, WV",Hampshire County, WV,2011,9800,8934,866,8.8
54,29,"Hancock County, WV",Hancock County, WV,2011,13894,12420,1474,10.6
54,31,"Hardy County, WV",Hardy County, WV,2011,5693,5095,598,10.5
54,33,"Harrison County, WV",Harrison County, WV,2011,31381,29143,2238,7.1
54,35,"Jackson County, WV",Jackson County, WV,2011,12018,10783,1235,10.3
54,37,"Jefferson County, WV",Jefferson County, WV,2011,27221,25523,1698,6.2
54,39,"Kanawha County, WV",Kanawha County, WV,2011,91673,85161,6512,7.1
54,41,"Lewis County, WV",Lewis County, WV,2011,7171,6636,535,7.5
54,43,"Lincoln County, WV",Lincoln County, WV,2011,7678,6860,818,10.7
54,45,"Logan County, WV",Logan County, WV,2011,12913,11764,1149,8.9
54,47,"McDowell County, WV",McDowell County, WV,2011,6671,5875,796,11.9
54,49,"Marion County, WV",Marion County, WV,2011,26740,24902,1838,6.9
54,51,"Marshall County, WV",Marshall County, WV,2011,14338,13056,1282,8.9
54,53,"Mason County, WV",Mason County, WV,2011,11051,9846,1205,10.9
54,55,"Mercer County, WV",Mercer County, WV,2011,23732,21694,2038,8.6
54,57,"Mineral County, WV",Mineral County, WV,2011,12183,11106,1077,8.8
54,59,"Mingo County, WV",Mingo County, WV,2011,9201,8410,791,8.6
54,61,"Monongalia County, WV",Monongalia County, WV,2011,48549,45850,2699,5.6
54,63,"Monroe County, WV",Monroe County, WV,2011,5781,5322,459,7.9
54,65,"Morgan County, WV",Morgan County, WV,2011,7588,6958,630,8.3
54,67,"Nicholas County, WV",Nicholas County, WV,2011,10952,9954,998,9.1
54,69,"Ohio County, WV",Ohio County, WV,2011,21324,19763,1561,7.3
54,71,"Pendleton County, WV",Pendleton County, WV,2011,3648,3385,263,7.2
54,73,"Pleasants County, WV",Pleasants County, WV,2011,2918,2633,285,9.8
54,75,"Pocahontas County, WV",Pocahontas County, WV,2011,3684,3275,409,11.1
54,77,"Preston County, WV",Preston County, WV,2011,14635,13519,1116,7.6
54,79,"Putnam County, WV",Putnam County, WV,2011,26290,24366,1924,7.3
54,81,"Raleigh County, WV",Raleigh County, WV,2011,33020,30644,2376,7.2
54,83,"Randolph County, WV",Randolph County, WV,2011,12083,10906,1177,9.7
54,85,"Ritchie County, WV",Ritchie County, WV,2011,4310,3918,392,9.1
54,87,"Roane County, WV",Roane County, WV,2011,5412,4712,700,12.9
54,89,"Summers County, WV",Summers County, WV,2011,4693,4258,435,9.3
54,91,"Taylor County, WV",Taylor County, WV,2011,7430,6878,552,7.4
54,93,"Tucker County, WV",Tucker County, WV,2011,3225,2922,303,9.4
54,95,"Tyler County, WV",Tyler County, WV,2011,3601,3222,379,10.5
54,97,"Upshur County, WV",Upshur County, WV,2011,10239,9351,888,8.7
54,99,"Wayne County, WV",Wayne County, WV,2011,16504,15157,1347,8.2
54,101,"Webster County, WV",Webster County, WV,2011,3632,3289,343,9.4
54,103,"Wetzel County, WV",Wetzel County, WV,2011,7043,6297,746,10.6
54,105,"Wirt County, WV",Wirt County, WV,2011,2278,2015,263,11.5
54,107,"Wood County, WV",Wood County, WV,2011,38647,35451,3196,8.3
54,109,"Wyoming County, WV",Wyoming County, WV,2011,8313,7581,732,8.8
55,1,"Adams County, WI",Adams County, WI,2011,9062,7993,1069,11.8
55,3,"Ashland County, WI",Ashland County, WI,2011,8310,7465,845,10.2
55,5,"Barron County, WI",Barron County, WI,2011,23751,21736,2015,8.5
55,7,"Bayfield County, WI",Bayfield County, WI,2011,7747,6912,835,10.8
55,9,"Brown County, WI",Brown County, WI,2011,137589,127685,9904,7.2
55,11,"Buffalo County, WI",Buffalo County, WI,2011,6953,6473,480,6.9
55,13,"Burnett County, WI",Burnett County, WI,2011,7584,6804,780,10.3
55,15,"Calumet County, WI",Calumet County, WI,2011,27520,25885,1635,5.9
55,17,"Chippewa County, WI",Chippewa County, WI,2011,33384,30796,2588,7.8
55,19,"Clark County, WI",Clark County, WI,2011,17320,15865,1455,8.4
55,21,"Columbia County, WI",Columbia County, WI,2011,31789,29280,2509,7.9
55,23,"Crawford County, WI",Crawford County, WI,2011,8456,7674,782,9.2
55,25,"Dane County, WI",Dane County, WI,2011,295299,279617,15682,5.3
55,27,"Dodge County, WI",Dodge County, WI,2011,47632,43910,3722,7.8
55,29,"Door County, WI",Door County, WI,2011,15610,13741,1869,12
55,31,"Douglas County, WI",Douglas County, WI,2011,23617,21839,1778,7.5
55,33,"Dunn County, WI",Dunn County, WI,2011,23373,21662,1711,7.3
55,35,"Eau Claire County, WI",Eau Claire County, WI,2011,57740,54031,3709,6.4
55,37,"Florence County, WI",Florence County, WI,2011,2211,1991,220,10
55,39,"Fond du Lac County, WI",Fond du Lac County, WI,2011,56211,52102,4109,7.3
55,41,"Forest County, WI",Forest County, WI,2011,4187,3701,486,11.6
55,43,"Grant County, WI",Grant County, WI,2011,27923,26026,1897,6.8
55,45,"Green County, WI",Green County, WI,2011,21130,19672,1458,6.9
55,47,"Green Lake County, WI",Green Lake County, WI,2011,10385,9534,851,8.2
55,49,"Iowa County, WI",Iowa County, WI,2011,13754,12742,1012,7.4
55,51,"Iron County, WI",Iron County, WI,2011,2756,2460,296,10.7
55,53,"Jackson County, WI",Jackson County, WI,2011,10225,9408,817,8
55,55,"Jefferson County, WI",Jefferson County, WI,2011,46443,42917,3526,7.6
55,57,"Juneau County, WI",Juneau County, WI,2011,13712,12449,1263,9.2
55,59,"Kenosha County, WI",Kenosha County, WI,2011,86421,78617,7804,9
55,61,"Kewaunee County, WI",Kewaunee County, WI,2011,11178,10350,828,7.4
55,63,"La Crosse County, WI",La Crosse County, WI,2011,65557,61637,3920,6
55,65,"Lafayette County, WI",Lafayette County, WI,2011,9481,8875,606,6.4
55,67,"Langlade County, WI",Langlade County, WI,2011,10063,9044,1019,10.1
55,69,"Lincoln County, WI",Lincoln County, WI,2011,15332,13823,1509,9.8
55,71,"Manitowoc County, WI",Manitowoc County, WI,2011,44505,40751,3754,8.4
55,73,"Marathon County, WI",Marathon County, WI,2011,72714,66981,5733,7.9
55,75,"Marinette County, WI",Marinette County, WI,2011,21527,19440,2087,9.7
55,77,"Marquette County, WI",Marquette County, WI,2011,7609,6851,758,10
55,78,"Menominee County, WI",Menominee County, WI,2011,1603,1328,275,17.2
55,79,"Milwaukee County, WI",Milwaukee County, WI,2011,477600,433264,44336,9.3
55,81,"Monroe County, WI",Monroe County, WI,2011,23183,21479,1704,7.4
55,83,"Oconto County, WI",Oconto County, WI,2011,21121,19092,2029,9.6
55,85,"Oneida County, WI",Oneida County, WI,2011,18896,17116,1780,9.4
55,87,"Outagamie County, WI",Outagamie County, WI,2011,100373,93281,7092,7.1
55,89,"Ozaukee County, WI",Ozaukee County, WI,2011,47450,44544,2906,6.1
55,91,"Pepin County, WI",Pepin County, WI,2011,4100,3839,261,6.4
55,93,"Pierce County, WI",Pierce County, WI,2011,23999,22549,1450,6
55,95,"Polk County, WI",Polk County, WI,2011,24147,22069,2078,8.6
55,97,"Portage County, WI",Portage County, WI,2011,39009,36072,2937,7.5
55,99,"Price County, WI",Price County, WI,2011,7228,6581,647,9
55,101,"Racine County, WI",Racine County, WI,2011,100519,91428,9091,9
55,103,"Richland County, WI",Richland County, WI,2011,9676,8955,721,7.5
55,105,"Rock County, WI",Rock County, WI,2011,81185,73447,7738,9.5
55,107,"Rusk County, WI",Rusk County, WI,2011,6888,6127,761,11
55,109,"St. Croix County, WI",St. Croix County, WI,2011,47519,44472,3047,6.4
55,111,"Sauk County, WI",Sauk County, WI,2011,36009,33270,2739,7.6
55,113,"Sawyer County, WI",Sawyer County, WI,2011,8185,7275,910,11.1
55,115,"Shawano County, WI",Shawano County, WI,2011,21775,19790,1985,9.1
55,117,"Sheboygan County, WI",Sheboygan County, WI,2011,61053,56060,4993,8.2
55,119,"Taylor County, WI",Taylor County, WI,2011,11298,10340,958,8.5
55,121,"Trempealeau County, WI",Trempealeau County, WI,2011,16198,15123,1075,6.6
55,123,"Vernon County, WI",Vernon County, WI,2011,15178,14121,1057,7
55,125,"Vilas County, WI",Vilas County, WI,2011,10164,9048,1116,11
55,127,"Walworth County, WI",Walworth County, WI,2011,56263,51769,4494,8
55,129,"Washburn County, WI",Washburn County, WI,2011,7985,7274,711,8.9
55,131,"Washington County, WI",Washington County, WI,2011,75294,70127,5167,6.9
55,133,"Waukesha County, WI",Waukesha County, WI,2011,217770,203711,14059,6.5
55,135,"Waupaca County, WI",Waupaca County, WI,2011,27711,25399,2312,8.3
55,137,"Waushara County, WI",Waushara County, WI,2011,11919,10752,1167,9.8
55,139,"Winnebago County, WI",Winnebago County, WI,2011,92400,85888,6512,7
55,141,"Wood County, WI",Wood County, WI,2011,40009,36673,3336,8.3
56,1,"Albany County, WY",Albany County, WY,2011,21832,20915,917,4.2
56,3,"Big Horn County, WY",Big Horn County, WY,2011,5741,5391,350,6.1
56,5,"Campbell County, WY",Campbell County, WY,2011,25872,24605,1267,4.9
56,7,"Carbon County, WY",Carbon County, WY,2011,8158,7670,488,6
56,9,"Converse County, WY",Converse County, WY,2011,7659,7289,370,4.8
56,11,"Crook County, WY",Crook County, WY,2011,3885,3696,189,4.9
56,13,"Fremont County, WY",Fremont County, WY,2011,21212,19844,1368,6.4
56,15,"Goshen County, WY",Goshen County, WY,2011,7641,7275,366,4.8
56,17,"Hot Springs County, WY",Hot Springs County, WY,2011,2600,2468,132,5.1
56,19,"Johnson County, WY",Johnson County, WY,2011,4517,4233,284,6.3
56,21,"Laramie County, WY",Laramie County, WY,2011,47167,44249,2918,6.2
56,23,"Lincoln County, WY",Lincoln County, WY,2011,8740,8054,686,7.8
56,25,"Natrona County, WY",Natrona County, WY,2011,41123,38628,2495,6.1
56,27,"Niobrara County, WY",Niobrara County, WY,2011,1395,1337,58,4.2
56,29,"Park County, WY",Park County, WY,2011,16094,15164,930,5.8
56,31,"Platte County, WY",Platte County, WY,2011,4963,4714,249,5
56,33,"Sheridan County, WY",Sheridan County, WY,2011,16062,14951,1111,6.9
56,35,"Sublette County, WY",Sublette County, WY,2011,5902,5632,270,4.6
56,37,"Sweetwater County, WY",Sweetwater County, WY,2011,23891,22633,1258,5.3
56,39,"Teton County, WY",Teton County, WY,2011,13637,12614,1023,7.5
56,41,"Uinta County, WY",Uinta County, WY,2011,10167,9537,630,6.2
56,43,"Washakie County, WY",Washakie County, WY,2011,4591,4335,256,5.6
56,45,"Weston County, WY",Weston County, WY,2011,3966,3785,181,4.6
72,1,"Adjuntas Municipio, PR",Adjuntas Municipio, PR,2011,5084,4009,1075,21.1
72,3,"Aguada Municipio, PR",Aguada Municipio, PR,2011,13118,10516,2602,19.8
72,5,"Aguadilla Municipio, PR",Aguadilla Municipio, PR,2011,16679,13369,3310,19.8
72,7,"Aguas Buenas Municipio, PR",Aguas Buenas Municipio, PR,2011,7569,5990,1579,20.9
72,9,"Aibonito Municipio, PR",Aibonito Municipio, PR,2011,7345,5879,1466,20
72,11,"Anasco Municipio, PR",Anasco Municipio, PR,2011,9608,7828,1780,18.5
72,13,"Arecibo Municipio, PR",Arecibo Municipio, PR,2011,26613,21888,4725,17.8
72,15,"Arroyo Municipio, PR",Arroyo Municipio, PR,2011,5945,4561,1384,23.3
72,17,"Barceloneta Municipio, PR",Barceloneta Municipio, PR,2011,6338,4909,1429,22.5
72,19,"Barranquitas Municipio, PR",Barranquitas Municipio, PR,2011,7952,6574,1378,17.3
72,21,"Bayamon Municipio, PR",Bayamon Municipio, PR,2011,73797,64479,9318,12.6
72,23,"Cabo Rojo Municipio, PR",Cabo Rojo Municipio, PR,2011,14928,12452,2476,16.6
72,25,"Caguas Municipio, PR",Caguas Municipio, PR,2011,52920,44964,7956,15
72,27,"Camuy Municipio, PR",Camuy Municipio, PR,2011,10345,8695,1650,15.9
72,29,"Canovanas Municipio, PR",Canovanas Municipio, PR,2011,17012,14218,2794,16.4
72,31,"Carolina Municipio, PR",Carolina Municipio, PR,2011,68174,59923,8251,12.1
72,33,"Catano Municipio, PR",Catano Municipio, PR,2011,8929,7578,1351,15.1
72,35,"Cayey Municipio, PR",Cayey Municipio, PR,2011,17621,14826,2795,15.9
72,37,"Ceiba Municipio, PR",Ceiba Municipio, PR,2011,4490,3559,931,20.7
72,39,"Ciales Municipio, PR",Ciales Municipio, PR,2011,4472,3382,1090,24.4
72,41,"Cidra Municipio, PR",Cidra Municipio, PR,2011,16957,14318,2639,15.6
72,43,"Coamo Municipio, PR",Coamo Municipio, PR,2011,12180,9471,2709,22.2
72,45,"Comerio Municipio, PR",Comerio Municipio, PR,2011,5611,4421,1190,21.2
72,47,"Corozal Municipio, PR",Corozal Municipio, PR,2011,10047,8267,1780,17.7
72,49,"Culebra Municipio, PR",Culebra Municipio, PR,2011,767,705,62,8.1
72,51,"Dorado Municipio, PR",Dorado Municipio, PR,2011,13086,11672,1414,10.8
72,53,"Fajardo Municipio, PR",Fajardo Municipio, PR,2011,13186,10512,2674,20.3
72,54,"Florida Municipio, PR",Florida Municipio, PR,2011,3680,2918,762,20.7
72,55,"Guanica Municipio, PR",Guanica Municipio, PR,2011,4929,3671,1258,25.5
72,57,"Guayama Municipio, PR",Guayama Municipio, PR,2011,14057,10882,3175,22.6
72,59,"Guayanilla Municipio, PR",Guayanilla Municipio, PR,2011,5910,4568,1342,22.7
72,61,"Guaynabo Municipio, PR",Guaynabo Municipio, PR,2011,39582,36423,3159,8
72,63,"Gurabo Municipio, PR",Gurabo Municipio, PR,2011,17302,15026,2276,13.2
72,65,"Hatillo Municipio, PR",Hatillo Municipio, PR,2011,13700,11388,2312,16.9
72,67,"Hormigueros Municipio, PR",Hormigueros Municipio, PR,2011,5949,5019,930,15.6
72,69,"Humacao Municipio, PR",Humacao Municipio, PR,2011,19629,15429,4200,21.4
72,71,"Isabela Municipio, PR",Isabela Municipio, PR,2011,12943,10411,2532,19.6
72,73,"Jayuya Municipio, PR",Jayuya Municipio, PR,2011,4733,3820,913,19.3
72,75,"Juana Diaz Municipio, PR",Juana Diaz Municipio, PR,2011,16785,13807,2978,17.7
72,77,"Juncos Municipio, PR",Juncos Municipio, PR,2011,13055,10653,2402,18.4
72,79,"Lajas Municipio, PR",Lajas Municipio, PR,2011,6258,4797,1461,23.3
72,81,"Lares Municipio, PR",Lares Municipio, PR,2011,7920,6278,1642,20.7
72,83,"Las Marias Municipio, PR",Las Marias Municipio, PR,2011,3928,3269,659,16.8
72,85,"Las Piedras Municipio, PR",Las Piedras Municipio, PR,2011,11997,9691,2306,19.2
72,87,"Loiza Municipio, PR",Loiza Municipio, PR,2011,9656,8200,1456,15.1
72,89,"Luquillo Municipio, PR",Luquillo Municipio, PR,2011,7072,5600,1472,20.8
72,91,"Manati Municipio, PR",Manati Municipio, PR,2011,12833,10595,2238,17.4
72,93,"Maricao Municipio, PR",Maricao Municipio, PR,2011,2201,1794,407,18.5
72,95,"Maunabo Municipio, PR",Maunabo Municipio, PR,2011,3444,2577,867,25.2
72,97,"Mayaguez Municipio, PR",Mayaguez Municipio, PR,2011,26408,21525,4883,18.5
72,99,"Moca Municipio, PR",Moca Municipio, PR,2011,11686,9294,2392,20.5
72,101,"Morovis Municipio, PR",Morovis Municipio, PR,2011,8854,7013,1841,20.8
72,103,"Naguabo Municipio, PR",Naguabo Municipio, PR,2011,8709,7033,1676,19.2
72,105,"Naranjito Municipio, PR",Naranjito Municipio, PR,2011,7935,6415,1520,19.2
72,107,"Orocovis Municipio, PR",Orocovis Municipio, PR,2011,5788,4591,1197,20.7
72,109,"Patillas Municipio, PR",Patillas Municipio, PR,2011,5692,4222,1470,25.8
72,111,"Penuelas Municipio, PR",Penuelas Municipio, PR,2011,7126,5514,1612,22.6
72,113,"Ponce Municipio, PR",Ponce Municipio, PR,2011,53626,44602,9024,16.8
72,115,"Quebradillas Municipio, PR",Quebradillas Municipio, PR,2011,6548,5273,1275,19.5
72,117,"Rincon Municipio, PR",Rincon Municipio, PR,2011,4907,3942,965,19.7
72,119,"Rio Grande Municipio, PR",Rio Grande Municipio, PR,2011,18180,15547,2633,14.5
72,121,"Sabana Grande Municipio, PR",Sabana Grande Municipio, PR,2011,7233,5661,1572,21.7
72,123,"Salinas Municipio, PR",Salinas Municipio, PR,2011,9069,6704,2365,26.1
72,125,"San German Municipio, PR",San German Municipio, PR,2011,11455,9321,2134,18.6
72,127,"San Juan Municipio, PR",San Juan Municipio, PR,2011,148387,133606,14781,10
72,129,"San Lorenzo Municipio, PR",San Lorenzo Municipio, PR,2011,12964,10677,2287,17.6
72,131,"San Sebastian Municipio, PR",San Sebastian Municipio, PR,2011,11581,8911,2670,23.1
72,133,"Santa Isabel Municipio, PR",Santa Isabel Municipio, PR,2011,9783,7633,2150,22
72,135,"Toa Alta Municipio, PR",Toa Alta Municipio, PR,2011,26694,23589,3105,11.6
72,137,"Toa Baja Municipio, PR",Toa Baja Municipio, PR,2011,32616,28600,4016,12.3
72,139,"Trujillo Alto Municipio, PR",Trujillo Alto Municipio, PR,2011,29102,26226,2876,9.9
72,141,"Utuado Municipio, PR",Utuado Municipio, PR,2011,7720,6159,1561,20.2
72,143,"Vega Alta Municipio, PR",Vega Alta Municipio, PR,2011,10505,8752,1753,16.7
72,145,"Vega Baja Municipio, PR",Vega Baja Municipio, PR,2011,15293,12430,2863,18.7
72,147,"Vieques Municipio, PR",Vieques Municipio, PR,2011,3174,2671,503,15.8
72,149,"Villalba Municipio, PR",Villalba Municipio, PR,2011,8485,6681,1804,21.3
72,151,"Yabucoa Municipio, PR",Yabucoa Municipio, PR,2011,10630,7924,2706,25.5
72,153,"Yauco Municipio, PR",Yauco Municipio, PR,2011,11760,9263,2497,21.2
